PLAYER,TEAM,AGE,GP,G,FREQ%,FGM,FGA,FG%,EFG%,2FG FREQ%,2FGM,2FGA,2FG%,3FG FREQ%,3PM,3PA,3P%
Russell Westbrook,OKC,28,81,81,33.2,247,614,40.2,47.8,19.0,154,351,43.9,14.2,93,263,35.4
Stephen Curry,GSW,29,79,79,35.7,231,495,46.7,60.2,12.5,97,173,56.1,23.2,134,322,41.6
Damian Lillard,POR,26,75,75,34.9,220,484,45.5,55.5,16.0,123,222,55.4,18.9,97,262,37.0
John Wall,WAS,26,78,77,35.2,212,474,44.7,48.7,26.4,174,356,48.9,8.8,38,118,32.2
James Harden,HOU,27,81,80,32.2,199,466,42.7,56.2,8.8,73,127,57.5,23.4,126,339,37.2
Paul George,IND,27,74,74,36.2,209,464,45.0,54.6,18.9,120,243,49.4,17.2,89,221,40.3
Kawhi Leonard,SAS,26,73,73,36.2,239,456,52.4,62.1,19.3,151,243,62.1,16.9,88,213,41.3
Kemba Walker,CHA,27,79,79,31.9,183,427,42.9,53.3,14.5,94,194,48.5,17.4,89,233,38.2
Bradley Beal,WAS,24,77,77,32.9,197,415,47.5,57.3,16.6,115,209,55.0,16.3,82,206,39.8
LeBron James,CLE,32,74,74,31.9,200,410,48.8,56.2,19.9,139,256,54.3,12.0,61,154,39.6
Klay Thompson,GSW,27,78,78,30.7,192,409,46.9,58.7,12.6,96,168,57.1,18.1,96,241,39.8
Isaiah Thomas,BOS,28,76,76,29.9,191,406,47.0,59.2,11.2,92,152,60.5,18.7,99,254,39.0
Carmelo Anthony,NYK,33,74,74,30.1,173,406,42.6,50.2,16.7,111,226,49.1,13.3,62,180,34.4
CJ McCollum,POR,25,80,80,29.5,193,403,47.9,55.1,18.8,135,256,52.7,10.8,58,147,39.5
Kyrie Irving,CLE,25,72,71,29.4,193,395,48.9,58.7,15.3,115,206,55.8,14.1,78,189,41.3
Devin Booker,PHX,20,76,76,29.6,159,385,41.3,49.0,15.9,100,207,48.3,13.7,59,178,33.1
Harrison Barnes,DAL,25,78,78,29.9,162,363,44.6,48.1,24.3,137,295,46.4,5.6,25,68,36.8
Anthony Davis,NOP,24,75,75,24.6,175,362,48.3,50.1,21.8,162,321,50.5,2.8,13,41,31.7
Goran Dragic,MIA,31,73,72,34.0,167,359,46.5,53.9,20.6,114,218,52.3,13.3,53,141,37.6
Mike Conley,MEM,29,69,66,36.6,159,355,44.8,56.3,17.1,77,166,46.4,19.5,82,189,43.4
Chris Paul,LAC,32,61,61,45.5,171,351,48.7,57.7,25.9,108,200,54.0,19.6,63,151,41.7
Gordon Hayward,UTA,27,73,71,31.1,183,347,52.7,61.7,19.1,121,213,56.8,12.0,62,134,46.3
Eric Bledsoe,PHX,27,64,64,34.3,142,333,42.6,50.5,19.8,90,192,46.9,14.5,52,141,36.9
Andrew Wiggins,MIN,22,82,81,22.6,156,332,47.0,52.3,16.0,121,235,51.5,6.6,35,97,36.1
JJ Redick,LAC,33,78,76,38.0,147,331,44.4,55.3,17.3,75,151,49.7,20.7,72,180,40.0
DeMarcus Cousins,NOP,26,72,71,24.9,136,331,41.1,47.7,16.0,92,212,43.4,9.0,44,119,37.0
DeMar DeRozan,TOR,27,73,71,22.8,152,327,46.5,50.0,18.2,129,261,49.4,4.6,23,66,34.8
Jimmy Butler,CHI,27,76,73,26.6,135,318,42.5,47.3,18.8,104,225,46.2,7.8,31,93,33.3
Jordan Clarkson,LAL,25,82,78,30.7,142,311,45.7,53.9,15.3,91,155,58.7,15.4,51,156,32.7
Marcus Morris Sr.,DET,27,79,79,31.4,123,309,39.8,47.4,16.1,76,159,47.8,15.2,47,150,31.3
Victor Oladipo,OKC,25,67,66,34.3,128,302,42.4,52.0,16.7,70,147,47.6,17.6,58,155,37.4
Eric Gordon,HOU,28,75,74,31.0,117,300,39.0,54.7,5.6,23,54,42.6,25.4,94,246,38.2
Kentavious Caldwell-Pope,DET,24,76,72,32.9,119,296,40.2,51.2,13.6,54,122,44.3,19.4,65,174,37.4
Dennis Schroder,ATL,23,79,78,26.2,132,289,45.7,51.2,16.3,100,180,55.6,9.9,32,109,29.4
Kyle Lowry,TOR,31,59,59,34.0,133,288,46.2,60.8,10.3,49,87,56.3,23.7,84,201,41.8
Lou Williams,HOU,30,81,79,30.6,127,288,44.1,56.4,11.3,56,106,52.8,19.3,71,182,39.0
Tim Hardaway Jr.,ATL,25,79,76,33.3,137,287,47.7,59.8,11.9,68,103,66.0,21.3,69,184,37.5
Tobias Harris,DET,24,82,81,28.1,134,286,46.9,53.0,17.5,99,178,55.6,10.6,35,108,32.4
Marc Gasol,MEM,32,74,72,24.5,136,278,48.9,51.3,20.8,123,236,52.1,3.7,13,42,31.0
Wesley Matthews,DAL,30,72,70,34.2,110,277,39.7,49.5,14.6,56,118,47.5,19.7,54,159,34.0
Otto Porter Jr.,WAS,24,80,78,34.4,134,272,49.3,58.5,18.4,84,145,57.9,16.1,50,127,39.4
Danilo Gallinari,DEN,28,62,61,37.8,112,269,41.6,52.4,17.0,54,121,44.6,20.8,58,148,39.2
Terrence Ross,ORL,26,77,75,37.1,109,268,40.7,50.9,14.4,54,104,51.9,22.7,55,164,33.5
Nicolas Batum,CHA,28,77,74,28.6,112,267,41.9,49.8,14.2,70,133,52.6,14.3,42,134,31.3
Ersan Ilyasova,ATL,30,82,78,31.6,118,266,44.4,54.9,12.1,62,102,60.8,19.5,56,164,34.1
Serge Ibaka,TOR,27,79,76,27.9,125,265,47.2,53.2,18.3,93,174,53.4,9.6,32,91,35.2
Giannis Antetokounmpo,MIL,22,80,77,22.1,118,262,45.0,46.4,17.7,111,210,52.9,4.4,7,52,13.5
Jrue Holiday,NOP,27,67,65,30.5,113,261,43.3,51.0,17.0,73,145,50.3,13.6,40,116,34.5
Derrick Rose,NYK,28,64,62,29.2,119,260,45.8,47.1,26.0,112,232,48.3,3.1,7,28,25.0
LaMarcus Aldridge,SAS,31,71,69,25.5,109,256,42.6,43.4,24.2,105,243,43.2,1.3,4,13,30.8
Paul Millsap,ATL,32,69,67,27.9,117,255,45.9,52.2,19.0,85,174,48.9,8.9,32,81,39.5
Jamal Crawford,LAC,37,82,81,29.9,117,255,45.9,54.9,15.7,71,134,53.0,14.2,46,121,38.0
Kevin Durant,GSW,28,62,61,25.4,137,254,53.9,64.4,12.1,84,121,69.4,13.3,53,133,39.8
Wilson Chandler,DEN,30,70,66,28.6,112,254,44.1,54.5,12.8,59,114,51.8,15.7,53,140,37.9
Langston Galloway,SAC,25,74,68,48.0,97,252,38.5,49.8,19.4,40,102,39.2,28.6,57,150,38.0
Jamal Murray,DEN,20,81,75,36.3,96,251,38.2,47.2,14.3,51,99,51.5,22.0,45,152,29.6
Dario Saric,PHI,23,81,77,29.5,96,251,38.2,45.8,16.5,58,140,41.4,13.0,38,111,34.2
Robert Covington,PHI,26,67,66,35.7,90,251,35.9,48.8,6.7,25,47,53.2,29.0,65,204,31.9
D'Angelo Russell,LAL,21,63,58,30.2,97,250,38.8,49.2,11.5,45,95,47.4,18.7,52,155,33.5
Tyler Johnson,MIA,25,73,68,32.0,93,247,37.7,44.3,19.2,60,148,40.5,12.8,33,99,33.3
Jae Crowder,BOS,26,72,70,34.3,97,243,39.9,53.3,11.6,32,82,39.0,22.7,65,161,40.4
Zach Randolph,MEM,35,73,73,27.1,91,243,37.4,38.5,24.1,86,216,39.8,3.0,5,27,18.5
Evan Fournier,ORL,24,68,67,28.0,106,241,44.0,54.4,12.1,56,104,53.8,15.9,50,137,36.5
Trevor Ariza,HOU,32,80,76,30.9,87,240,36.3,48.3,5.8,29,45,64.4,25.1,58,195,29.7
Blake Griffin,LAC,28,61,61,25.6,109,239,45.6,46.9,22.8,103,213,48.4,2.8,6,26,23.1
Ish Smith,DET,28,81,73,33.2,109,237,46.0,47.0,30.4,104,217,47.9,2.8,5,20,25.0
Reggie Jackson,DET,27,52,51,36.4,100,235,42.6,50.6,20.6,62,133,46.6,15.8,38,102,37.3
Karl-Anthony Towns,MIN,21,82,79,16.8,117,233,50.2,54.7,12.9,96,179,53.6,3.9,21,54,38.9
Seth Curry,DAL,26,69,64,34.6,113,232,48.7,59.5,16.4,63,110,57.3,18.2,50,122,41.0
Dwyane Wade,CHI,35,60,58,25.4,107,230,46.5,51.1,19.6,86,178,48.3,5.7,21,52,40.4
Buddy Hield,SAC,24,82,72,31.8,97,230,42.2,53.5,14.1,45,102,44.1,17.7,52,128,40.6
Kristaps Porzingis,NYK,21,66,64,23.9,96,228,42.1,50.2,12.2,59,116,50.9,11.7,37,112,33.0
Wayne Ellington,MIA,29,62,61,41.6,90,227,39.6,52.4,9.9,32,54,59.3,31.7,58,173,33.5
Kevin Love,CLE,28,60,58,27.8,92,225,40.9,50.4,13.0,49,105,46.7,14.8,43,120,35.8
Nick Young,LAL,32,60,59,35.9,97,223,43.5,59.4,9.3,26,58,44.8,26.5,71,165,43.0
Jameer Nelson,DEN,35,74,70,38.8,92,223,41.3,50.9,17.7,49,102,48.0,21.0,43,121,35.5
Marco Belinelli,CHA,31,74,70,36.8,102,222,45.9,55.0,19.1,62,115,53.9,17.7,40,107,37.4
Bojan Bogdanovic,WAS,28,80,75,28.9,98,222,44.1,57.4,8.3,39,64,60.9,20.6,59,158,37.3
Aaron Gordon,ORL,21,80,72,26.8,89,220,40.5,43.4,18.1,76,149,51.0,8.6,13,71,18.3
Nikola Mirotic,CHI,26,70,69,37.0,80,220,36.4,48.2,9.9,28,59,47.5,27.1,52,161,32.3
Nikola Vucevic,ORL,26,75,71,21.9,108,218,49.5,49.8,21.1,107,210,51.0,0.8,1,8,12.5
E'Twaun Moore,NOP,28,73,69,36.3,103,216,47.7,55.3,21.5,70,128,54.7,14.8,33,88,37.5
Darren Collison,SAC,29,68,66,31.6,105,214,49.1,52.8,24.3,89,165,53.9,7.2,16,49,32.7
Will Barton,DEN,26,59,55,34.8,97,212,45.8,58.7,12.0,42,73,57.5,22.8,55,139,39.6
Ryan Anderson,HOU,29,72,71,28.3,92,212,43.4,58.5,8.4,28,63,44.4,19.9,64,149,43.0
Zach LaVine,MIN,22,47,47,31.4,91,211,43.1,52.4,14.9,52,100,52.0,16.5,39,111,35.1
Dirk Nowitzki,DAL,39,53,51,32.3,88,211,41.7,47.9,19.9,62,130,47.7,12.4,26,81,32.1
T.J. Warren,PHX,23,64,61,28.0,102,210,48.6,50.0,24.0,96,180,53.3,4.0,6,30,20.0
Dion Waiters,MIA,25,46,45,33.2,90,207,43.5,52.9,17.7,51,110,46.4,15.6,39,97,40.2
Avery Bradley,BOS,26,55,54,28.5,99,204,48.5,57.6,15.0,62,107,57.9,13.6,37,97,38.1
Deron Williams,CLE,33,63,56,35.9,94,202,46.5,55.7,17.6,57,99,57.6,18.3,37,103,35.9
Austin Rivers,LAC,24,74,71,29.2,90,200,45.0,58.5,9.6,36,66,54.5,19.6,54,134,40.3
Brandon Jennings,WAS,27,81,66,37.9,68,196,34.7,43.4,15.3,34,79,43.0,22.6,34,117,29.1
Courtney Lee,NYK,31,77,73,28.6,95,195,48.7,57.7,15.4,60,105,57.1,13.2,35,90,38.9
Patty Mills,SAS,28,80,76,32.0,84,194,43.3,54.1,13.5,42,82,51.2,18.5,42,112,37.5
Allen Crabbe,POR,25,79,72,30.4,87,191,45.5,57.3,13.8,42,87,48.3,16.5,45,104,43.3
Joe Johnson,UTA,36,78,76,30.9,77,190,40.5,50.0,15.3,41,94,43.6,15.6,36,96,37.5
Vince Carter,MEM,40,73,67,40.2,74,190,38.9,52.6,11.6,22,55,40.0,28.5,52,135,38.5
CJ Miles,IND,30,75,70,30.5,66,187,35.3,48.4,7.2,17,44,38.6,23.3,49,143,34.3
Gary Harris,DEN,22,56,53,31.4,88,186,47.3,58.9,11.8,45,70,64.3,19.6,43,116,37.1
Sean Kilpatrick,BKN,27,69,65,27.9,82,186,44.1,54.6,11.4,43,76,56.6,16.5,39,110,35.5
Jabari Parker,MIL,22,51,49,24.7,80,185,43.2,48.6,17.6,60,132,45.5,7.1,20,53,37.7
Kent Bazemore,ATL,27,73,66,26.5,81,183,44.3,51.4,16.1,55,111,49.5,10.4,26,72,36.1
Rodney Hood,UTA,24,59,55,28.2,77,183,42.1,54.6,9.6,31,62,50.0,18.7,46,121,38.0
Justin Holiday,NYK,28,82,72,35.3,72,183,39.3,47.8,15.6,41,81,50.6,19.7,31,102,30.4
Patrick Beverley,HOU,28,67,63,35.8,72,183,39.3,52.2,10.2,25,52,48.1,25.6,47,131,35.9
Troy Daniels,MEM,25,67,57,37.7,76,182,41.8,58.5,7.7,15,37,40.5,30.0,61,145,42.1
Gorgui Dieng,MIN,27,82,74,29.4,91,180,50.6,51.4,27.2,88,167,52.7,2.1,3,13,23.1
Cory Joseph,TOR,25,79,70,29.1,86,178,48.3,52.5,21.4,71,131,54.2,7.7,15,47,31.9
Brook Lopez,BKN,29,75,63,15.8,85,177,48.0,56.8,9.4,54,106,50.9,6.3,31,71,43.7
Markieff Morris,WAS,27,76,68,21.0,85,177,48.0,51.1,16.1,74,136,54.4,4.9,11,41,26.8
Jeff Teague,IND,29,81,73,21.6,84,175,48.0,53.1,14.1,66,114,57.9,7.5,18,61,29.5
Marcus Smart,BOS,23,79,73,25.0,67,175,38.3,48.9,9.2,30,64,46.9,15.9,37,111,33.3
Nik Stauskas,PHI,23,80,66,29.3,63,175,36.0,46.6,9.0,26,54,48.1,20.3,37,121,30.6
Elfrid Payton,ORL,23,82,73,21.4,91,173,52.6,56.9,16.0,76,130,58.5,5.3,15,43,34.9
Iman Shumpert,CLE,27,76,70,36.3,70,173,40.5,49.4,16.6,39,79,49.4,19.7,31,94,33.0
D.J. Augustin,ORL,29,78,70,35.7,73,172,42.4,56.1,10.8,26,52,50.0,24.9,47,120,39.2
Nikola Jokic,DEN,22,72,60,21.5,93,171,54.4,59.6,14.8,75,118,63.6,6.7,18,53,34.0
DeMarre Carroll,TOR,30,71,68,33.3,68,170,40.0,52.9,7.4,24,38,63.2,25.8,44,132,33.3
Josh Richardson,MIA,23,53,51,34.1,66,169,39.1,48.5,14.7,34,73,46.6,19.4,32,96,33.3
Kyle Korver,CLE,36,67,65,33.2,71,168,42.3,58.0,8.1,18,41,43.9,25.1,53,127,41.7
Sergio Rodriguez,PHI,31,68,60,32.6,66,168,39.3,46.7,19.4,41,100,41.0,13.2,25,68,36.8
Mirza Teletovic,MIL,31,70,62,41.1,62,168,36.9,51.8,5.6,12,23,52.2,35.5,50,145,34.5
Al Horford,BOS,31,68,61,21.4,72,166,43.4,45.8,17.9,64,139,46.0,3.5,8,27,29.6
Emmanuel Mudiay,DEN,21,54,51,33.0,56,164,34.1,40.9,16.9,34,84,40.5,16.1,22,80,27.5
James Johnson,MIA,30,76,64,22.4,85,163,52.1,60.4,12.1,58,88,65.9,10.3,27,75,36.0
Raymond Felton,LAC,33,80,65,32.7,65,161,40.4,43.2,23.8,56,117,47.9,8.9,9,44,20.5
Ty Lawson,SAC,29,69,61,33.8,79,159,49.7,52.8,28.5,69,134,51.5,5.3,10,25,40.0
Brandon Knight,PHX,25,53,50,32.5,66,159,41.5,46.9,21.3,49,104,47.1,11.2,17,55,30.9
Tony Snell,MIL,25,80,70,29.9,68,158,43.0,55.7,8.5,28,45,62.2,21.4,40,113,35.4
Myles Turner,IND,21,80,69,19.4,91,157,58.0,59.2,17.9,87,145,60.0,1.5,4,12,33.3
Hassan Whiteside,MIA,28,77,67,17.0,86,155,55.5,55.5,17.0,86,155,55.5,0.0,0,0,-
Tony Parker,SAS,35,62,55,30.0,80,155,51.6,54.2,25.8,72,133,54.1,4.3,8,22,36.4
George Hill,UTA,31,49,46,26.4,68,155,43.9,52.3,15.6,42,92,45.7,10.7,26,63,41.3
Rajon Rondo,CHI,31,69,63,29.2,59,154,38.3,43.8,19.9,42,105,40.0,9.3,17,49,34.7
Evan Turner,POR,28,65,56,29.6,72,152,47.4,48.0,26.1,70,134,52.2,3.5,2,18,11.1
Jon Leuer,DET,28,75,67,24.5,64,148,43.2,45.3,19.0,58,115,50.4,5.5,6,33,18.2
Ricky Rubio,MIN,26,75,61,23.9,59,148,39.9,41.6,18.7,54,116,46.6,5.2,5,32,15.6
Marvin Williams,CHA,31,76,69,22.1,54,148,36.5,47.6,6.3,21,42,50.0,15.8,33,106,31.1
Monta Ellis,IND,31,73,61,28.0,72,145,49.7,55.5,19.5,55,101,54.5,8.5,17,44,38.6
Jeremy Lamb,CHA,25,62,54,30.6,61,145,42.1,47.6,16.5,45,78,57.7,14.1,16,67,23.9
Taj Gibson,OKC,32,78,65,22.2,77,144,53.5,53.5,21.9,77,142,54.2,0.3,0,2,0.0
Frank Kaminsky,CHA,24,75,63,18.7,58,143,40.6,45.1,12.7,45,97,46.4,6.0,13,46,28.3
Tyler Ulis,PHX,21,59,44,35.5,72,141,51.1,51.8,32.7,70,130,53.8,2.8,2,11,18.2
Arron Afflalo,SAC,31,61,55,35.7,63,140,45.0,54.3,20.4,37,80,46.3,15.3,26,60,43.3
Joe Ingles,UTA,29,82,61,32.0,61,139,43.9,58.6,8.7,20,38,52.6,23.2,41,101,40.6
Gerald Henderson,PHI,29,72,63,26.5,57,139,41.0,51.1,12.6,29,66,43.9,13.9,28,73,38.4
Brandon Ingram,LAL,19,79,57,21.6,60,137,43.8,48.2,13.9,48,88,54.5,7.7,12,49,24.5
Michael Kidd-Gilchrist,CHA,23,81,69,24.8,68,136,50.0,50.0,24.5,68,134,50.7,0.4,0,2,0.0
Malcolm Delaney,ATL,28,73,65,36.7,62,135,45.9,50.4,25.5,50,94,53.2,11.1,12,41,29.3
Alex Abrines,OKC,23,68,53,40.5,54,135,40.0,56.7,6.6,9,22,40.9,33.9,45,113,39.8
Matthew Dellavedova,MIL,26,76,62,26.7,41,135,30.4,37.0,15.0,23,76,30.3,11.7,18,59,30.5
Garrett Temple,SAC,31,65,58,32.4,53,134,39.6,47.4,17.2,32,71,45.1,15.3,21,63,33.3
Ben McLemore,SAC,24,61,51,32.6,53,129,41.1,51.2,15.2,27,60,45.0,17.4,26,69,37.7
Channing Frye,CLE,34,74,63,25.0,52,128,40.6,51.2,9.0,25,46,54.3,16.0,27,82,32.9
Yogi Ferrell,DAL,24,46,42,34.4,49,128,38.3,47.7,17.5,25,65,38.5,16.9,24,63,38.1
Julius Randle,LAL,22,74,57,18.0,60,126,47.6,48.8,16.7,57,117,48.7,1.3,3,9,33.3
Jeremy Lin,BKN,28,35,33,34.1,53,125,42.4,51.2,16.1,31,59,52.5,18.0,22,66,33.3
Draymond Green,GSW,27,76,58,20.5,44,125,35.2,40.8,8.4,30,51,58.8,12.2,14,74,18.9
Solomon Hill,NOP,26,80,65,27.6,44,125,35.2,45.2,9.5,19,43,44.2,18.1,25,82,30.5
Terry Rozier,BOS,23,74,59,31.9,46,124,37.1,45.2,15.2,26,59,44.1,16.7,20,65,30.8
Luol Deng,LAL,32,56,48,30.8,44,123,35.8,44.7,13.5,22,54,40.7,17.3,22,69,31.9
Jonas Valanciunas,TOR,25,79,59,18.5,66,122,54.1,54.1,18.5,66,122,54.1,0.0,0,0,-
JaMychal Green,MEM,27,77,63,26.7,55,122,45.1,52.0,14.9,38,68,55.9,11.8,17,54,31.5
Rodney McGruder,MIA,25,78,63,28.0,48,122,39.3,46.3,11.7,31,51,60.8,16.3,17,71,23.9
JR Smith,CLE,31,41,38,34.8,38,122,31.1,44.3,6.3,6,22,27.3,28.5,32,100,32.0
Doug McDermott,OKC,25,66,50,25.7,58,121,47.9,57.9,11.7,34,55,61.8,14.0,24,66,36.4
Mario Hezonja,ORL,22,65,54,38.5,43,121,35.5,44.6,17.5,21,55,38.2,21.0,22,66,33.3
Jonathon Simmons,SAS,27,77,52,31.7,53,120,44.2,48.8,22.5,42,85,49.4,9.3,11,35,31.4
Jeff Green,ORL,30,69,54,22.4,43,120,35.8,40.4,12.5,32,67,47.8,9.9,11,53,20.8
Thaddeus Young,IND,29,73,57,18.7,67,119,56.3,59.2,14.3,60,91,65.9,4.4,7,28,25.0
J.J. Barea,DAL,33,34,32,36.8,54,118,45.8,57.2,17.1,27,55,49.1,19.6,27,63,42.9
Danny Green,SAS,30,67,55,27.5,50,118,42.4,58.5,6.3,12,27,44.4,21.2,38,91,41.8
T.J. McConnell,PHI,25,81,60,23.8,55,115,47.8,48.3,22.8,54,110,49.1,1.0,1,5,20.0
Joe Harris,BKN,25,51,46,33.9,52,113,46.0,63.3,6.9,13,23,56.5,27.0,39,90,43.3
Isaiah Whitehead,BKN,22,73,56,24.8,38,113,33.6,38.5,13.4,27,61,44.3,11.4,11,52,21.2
Manu Ginobili,SAS,39,68,51,27.1,41,112,36.6,47.8,9.7,16,40,40.0,17.4,25,72,34.7
Andre Iguodala,GSW,33,76,58,27.2,49,110,44.5,51.4,12.6,34,51,66.7,14.6,15,59,25.4
Jared Dudley,PHX,31,64,50,32.3,43,109,39.4,50.9,11.6,18,39,46.2,20.8,25,70,35.7
Anthony Tolliver,SAC,32,65,54,32.5,38,109,34.9,47.2,6.0,11,20,55.0,26.6,27,89,30.3
Jason Smith,WAS,31,74,54,34.4,57,108,52.8,57.4,26.1,47,82,57.3,8.3,10,26,38.5
Matt Barnes,GSW,37,74,60,23.7,49,107,45.8,57.5,9.3,24,42,57.1,14.4,25,65,38.5
Marcin Gortat,WAS,33,82,59,17.0,70,106,66.0,66.0,16.9,70,105,66.7,0.2,0,1,0.0
Norman Powell,TOR,24,75,56,23.3,44,106,41.5,47.2,12.7,32,58,55.2,10.5,12,48,25.0
Andre Drummond,DET,23,81,56,12.2,70,104,67.3,67.3,12.0,70,102,68.6,0.2,0,2,0.0
Kyle O'Quinn,NYK,27,79,57,26.9,43,104,41.3,41.3,25.6,43,99,43.4,1.3,0,5,0.0
Marreese Speights,LAC,29,82,58,19.8,42,104,40.4,51.4,6.3,19,33,57.6,13.5,23,71,32.4
Tyreke Evans,SAC,27,40,37,30.2,39,104,37.5,47.1,14.2,19,49,38.8,16.0,20,55,36.4
Pau Gasol,SAS,36,63,52,18.3,56,103,54.4,59.2,14.8,46,83,55.4,3.6,10,20,50.0
Enes Freedom,OKC,25,72,52,15.7,52,101,51.5,52.5,13.8,50,89,56.2,1.9,2,12,16.7
Stanley Johnson,DET,21,77,53,28.7,31,100,31.0,36.0,17.2,21,60,35.0,11.5,10,40,25.0
Trey Burke,WAS,24,57,41,40.2,51,99,51.5,60.1,25.2,34,62,54.8,15.0,17,37,45.9
Rondae Hollis-Jefferson,BKN,22,77,53,20.5,45,99,45.5,45.5,19.0,45,92,48.9,1.4,0,7,0.0
Mindaugas Kuzminskas,NYK,27,68,47,29.3,34,98,34.7,43.4,7.2,17,24,70.8,22.2,17,74,23.0
Maurice Harkless,POR,24,77,60,16.9,47,97,48.5,55.7,8.4,33,48,68.8,8.5,14,49,28.6
Malcolm Brogdon,MIL,24,75,53,16.4,42,97,43.3,47.4,12.0,34,71,47.9,4.4,8,26,30.8
Aaron Brooks,IND,32,64,46,35.1,40,97,41.2,53.1,14.5,17,40,42.5,20.7,23,57,40.4
Randy Foye,BKN,33,68,51,31.7,34,97,35.1,46.9,6.5,11,20,55.0,25.2,23,77,29.9
Derrick Favors,UTA,25,50,40,24.9,45,96,46.9,46.9,24.6,45,95,47.4,0.3,0,1,0.0
Devin Harris,DAL,34,64,44,30.0,39,96,40.6,52.1,9.1,17,29,58.6,20.9,22,67,32.8
Mason Plumlee,DEN,27,81,58,16.6,51,95,53.7,53.7,16.5,51,94,54.3,0.2,0,1,0.0
Khris Middleton,MIL,25,29,29,29.6,46,95,48.4,56.8,17.1,30,55,54.5,12.5,16,40,40.0
Bobby Portis,CHI,22,64,45,27.0,42,95,44.2,46.3,21.3,38,75,50.7,5.7,4,20,20.0
Kelly Oubre Jr.,WAS,21,79,51,23.4,40,95,42.1,52.6,8.9,20,36,55.6,14.5,20,59,33.9
Joel Embiid,PHI,23,31,29,23.9,52,94,55.3,58.5,19.8,46,78,59.0,4.1,6,16,37.5
Dante Cunningham,NOP,30,66,46,27.6,40,94,42.6,52.7,11.5,21,39,53.8,16.2,19,55,34.5
Trevor Booker,BKN,29,70,56,16.9,43,93,46.2,46.8,14.7,42,81,51.9,2.2,1,12,8.3
Tim Frazier,NOP,26,65,49,24.6,41,93,44.1,51.6,15.9,27,60,45.0,8.7,14,33,42.4
Jerian Grant,CHI,24,63,43,31.8,37,93,39.8,50.0,12.0,18,35,51.4,19.9,19,58,32.8
Denzel Valentine,CHI,23,57,41,32.7,35,93,37.6,50.5,8.5,11,24,45.8,24.3,24,69,34.8
Justin Anderson,PHI,23,74,48,22.1,30,93,32.3,39.2,9.8,17,41,41.5,12.4,13,52,25.0
Marquese Chriss,PHX,19,80,53,16.3,52,92,56.5,60.9,12.6,44,71,62.0,3.7,8,21,38.1
Davis Bertans,SAS,24,66,41,40.1,40,91,44.0,60.4,7.5,10,17,58.8,32.6,30,74,40.5
Richard Jefferson,CLE,37,79,57,28.0,36,91,39.6,51.1,8.6,15,28,53.6,19.4,21,63,33.3
Patrick Patterson,TOR,28,65,48,24.1,38,90,42.2,54.4,7.2,16,27,59.3,16.9,22,63,34.9
Shelvin Mack,UTA,27,55,41,24.6,42,89,47.2,53.9,14.9,30,54,55.6,9.7,12,35,34.3
Caris LeVert,BKN,22,56,46,24.4,39,88,44.3,55.7,9.4,19,34,55.9,15.0,20,54,37.0
Jordan Crawford,NOP,28,19,19,40.6,34,88,38.6,46.6,19.8,20,43,46.5,20.7,14,45,31.1
Jaylen Brown,BOS,20,78,42,22.6,33,88,37.5,44.3,12.6,21,49,42.9,10.0,12,39,30.8
Willie Cauley-Stein,SAC,23,75,47,19.5,46,87,52.9,52.9,19.3,46,86,53.5,0.2,0,1,0.0
Glenn Robinson III,IND,23,68,50,27.8,39,87,44.8,53.4,15.3,24,48,50.0,12.5,15,39,38.5
Andrew Harrison,MEM,22,72,48,26.4,37,87,42.5,51.1,15.2,22,50,44.0,11.2,15,37,40.5
Steven Adams,OKC,23,80,50,14.1,55,86,64.0,64.0,14.1,55,86,64.0,0.0,0,0,-
Greg Monroe,MIL,27,81,50,13.0,54,86,62.8,62.8,13.0,54,86,62.8,0.0,0,0,-
Terrence Jones,MIL,25,54,44,19.0,40,86,46.5,50.6,13.3,33,60,55.0,5.8,7,26,26.9
Justin Hamilton,BKN,27,63,43,24.3,39,86,45.3,53.5,11.0,25,39,64.1,13.3,14,47,29.8
P.J. Tucker,TOR,32,79,52,19.5,40,85,47.1,57.6,9.4,22,41,53.7,10.1,18,44,40.9
Rudy Gay,SAC,30,30,27,20.0,44,84,52.4,60.1,12.6,31,53,58.5,7.4,13,31,41.9
Meyers Leonard,POR,25,74,47,22.7,32,84,38.1,45.2,12.7,20,47,42.6,10.0,12,37,32.4
Trey Lyles,UTA,21,71,45,19.9,31,84,36.9,42.3,9.9,22,42,52.4,9.9,9,42,21.4
Luc Mbah a Moute,LAC,30,80,56,23.9,45,83,54.2,58.4,17.6,38,61,62.3,6.3,7,22,31.8
C.J. Watson,ORL,33,62,47,34.5,39,82,47.6,56.1,20.2,25,48,52.1,14.3,14,34,41.2
Leandro Barbosa,PHX,34,65,45,22.8,36,82,43.9,48.2,16.7,29,60,48.3,6.1,7,22,31.8
Thabo Sefolosha,ATL,33,62,44,22.3,35,82,42.7,50.6,14.1,22,52,42.3,8.2,13,30,43.3
Robin Lopez,CHI,29,81,53,11.0,49,81,60.5,60.5,10.9,49,80,61.3,0.1,0,1,0.0
Kelly Olynyk,BOS,26,75,53,16.7,41,80,51.3,55.0,12.3,35,59,59.3,4.4,6,21,28.6
Jahlil Okafor,PHI,21,50,39,18.8,40,80,50.0,50.0,18.8,40,80,50.0,0.0,0,0,-
Ian Clark,GSW,26,77,47,19.3,33,79,41.8,44.9,12.2,28,50,56.0,7.1,5,29,17.2
Al Jefferson,IND,32,65,43,17.9,42,78,53.8,53.8,17.9,42,78,53.8,0.0,0,0,-
Michael Beasley,MIL,28,56,38,20.3,27,78,34.6,36.5,17.2,24,66,36.4,3.1,3,12,25.0
Kris Dunn,MIN,23,78,51,25.4,27,75,36.0,40.0,18.3,21,54,38.9,7.1,6,21,28.6
Domantas Sabonis,OKC,21,81,44,16.4,31,74,41.9,49.3,10.2,20,46,43.5,6.2,11,28,39.3
Spencer Dinwiddie,BKN,24,58,40,26.8,39,73,53.4,63.7,14.3,24,39,61.5,12.5,15,34,44.1
Shabazz Muhammad,MIN,24,78,43,13.3,33,73,45.2,52.1,8.0,23,44,52.3,5.3,10,29,34.5
Al-Farouq Aminu,POR,26,61,45,16.5,32,73,43.8,55.5,7.0,15,31,48.4,9.5,17,42,40.5
Luke Babbitt,MIA,28,68,44,26.5,29,73,39.7,55.5,6.9,6,19,31.6,19.6,23,54,42.6
Dwight Howard,ATL,31,74,45,12.6,56,72,77.8,77.8,12.6,56,72,77.8,0.0,0,0,-
Shabazz Napier,POR,25,53,33,41.4,35,72,48.6,61.1,17.2,17,30,56.7,24.1,18,42,42.9
Derrick Williams,CLE,26,50,35,31.9,33,72,45.8,53.5,17.7,22,40,55.0,14.2,11,32,34.4
Taurean Prince,ATL,23,59,39,27.7,32,72,44.4,52.8,15.4,20,40,50.0,12.3,12,32,37.5
Nene,HOU,34,67,45,19.7,38,71,53.5,54.2,18.6,37,67,55.2,1.1,1,4,25.0
Nerlens Noel,DAL,23,51,36,23.9,34,71,47.9,47.9,23.9,34,71,47.9,0.0,0,0,-
Alex Len,PHX,24,75,46,17.3,34,71,47.9,47.9,16.6,34,68,50.0,0.7,0,3,0.0
Sam Dekker,HOU,23,77,43,17.3,33,71,46.5,53.5,8.0,23,33,69.7,9.2,10,38,26.3
Dorian Finney-Smith,DAL,24,80,44,23.1,25,71,35.2,43.0,7.5,14,23,60.9,15.6,11,48,22.9
James Ennis III,MEM,26,64,42,24.0,31,70,44.3,52.1,12.0,20,35,57.1,12.0,11,35,31.4
Willy Hernangomez,NYK,23,72,39,16.0,44,69,63.8,64.5,15.3,43,66,65.2,0.7,1,3,33.3
Darrell Arthur,DEN,29,41,31,32.9,33,69,47.8,60.9,16.7,15,35,42.9,16.2,18,34,52.9
DeAndre Jordan,LAC,28,81,46,12.3,60,68,88.2,88.2,12.3,60,68,88.2,0.0,0,0,-
Dante Exum,UTA,21,66,41,20.4,31,68,45.6,55.1,9.0,18,30,60.0,11.4,13,38,34.2
Dwight Powell,DAL,25,76,37,19.7,30,68,44.1,46.3,14.8,27,51,52.9,4.9,3,17,17.6
Jodie Meeks,ORL,29,36,30,27.9,27,68,39.7,55.1,8.2,6,20,30.0,19.7,21,48,43.8
Kosta Koufos,SAC,28,71,41,18.5,35,67,52.2,52.2,18.5,35,67,52.2,0.0,0,0,-
Joffrey Lauvergne,CHI,25,70,43,21.5,33,67,49.3,56.0,13.1,24,41,58.5,8.3,9,26,34.6
Chandler Parsons,MEM,28,34,31,32.4,24,67,35.8,43.3,14.0,14,29,48.3,18.4,10,38,26.3
Timothe Luwawu-Cabarrot,PHI,22,69,37,20.3,23,65,35.4,47.7,4.1,7,13,53.8,16.3,16,52,30.8
Jerami Grant,OKC,23,80,45,21.4,29,64,45.3,53.1,12.7,19,38,50.0,8.7,10,26,38.5
Beno Udrih,DET,34,39,30,35.2,28,64,43.8,48.4,26.4,22,48,45.8,8.8,6,16,37.5
Wesley Johnson,LAC,29,68,43,32.7,20,64,31.3,39.1,10.2,10,20,50.0,22.4,10,44,22.7
Corey Brewer,LAL,31,82,41,19.7,30,63,47.6,53.2,10.9,23,35,65.7,8.8,7,28,25.0
Tony Allen,MEM,35,71,39,12.0,29,63,46.0,47.6,9.9,27,52,51.9,2.1,2,11,18.2
Mike Muscala,ATL,25,70,39,19.0,33,62,53.2,55.6,16.5,30,54,55.6,2.4,3,8,37.5
Clint Capela,HOU,23,65,37,11.9,57,60,95.0,95.0,11.9,57,60,95.0,0.0,0,0,-
Larry Nance Jr.,LAL,24,63,36,17.1,37,60,61.7,63.3,15.4,35,54,64.8,1.7,2,6,33.3
Marcus Thornton,WAS,30,33,25,30.0,23,60,38.3,50.0,10.5,9,21,42.9,19.5,14,39,35.9
Cody Zeller,CHA,24,62,40,15.2,41,59,69.5,69.5,15.2,41,59,69.5,0.0,0,0,-
Ramon Sessions,CHA,31,50,33,24.8,23,59,39.0,44.9,17.6,16,42,38.1,7.1,7,17,41.2
Lance Thomas,NYK,29,46,32,25.6,24,58,41.4,49.1,18.5,15,42,35.7,7.0,9,16,56.3
Anthony Morrow,CHI,31,49,32,24.0,23,58,39.7,51.7,7.4,9,18,50.0,16.5,14,40,35.0
Rudy Gobert,UTA,25,81,43,10.1,50,57,87.7,87.7,10.1,50,57,87.7,0.0,0,0,-
Richaun Holmes,PHI,23,57,31,14.7,35,57,61.4,63.2,13.9,33,54,61.1,0.8,2,3,66.7
Boris Diaw,UTA,35,73,40,17.6,30,56,53.6,57.1,14.4,26,46,56.5,3.1,4,10,40.0
Sasha Vujacic,NYK,33,42,25,42.7,16,56,28.6,36.6,16.0,7,21,33.3,26.7,9,35,25.7
Rodney Stuckey,IND,31,39,26,24.1,25,55,45.5,48.2,18.9,22,43,51.2,5.3,3,12,25.0
Gerald Green,BOS,31,47,33,24.9,25,55,45.5,58.2,9.5,11,21,52.4,15.4,14,34,41.2
Cameron Payne,CHI,22,31,27,29.7,22,55,40.0,48.2,14.6,13,27,48.1,15.1,9,28,32.1
Timofey Mozgov,LAL,30,54,37,17.9,31,54,57.4,57.4,17.5,31,53,58.5,0.3,0,1,0.0
Jason Terry,MIL,39,74,34,23.0,20,54,37.0,49.1,6.0,7,14,50.0,17.0,13,40,32.5
Michael Carter-Williams,CHI,25,45,31,19.1,16,54,29.6,33.3,12.7,12,36,33.3,6.4,4,18,22.2
Mike Dunleavy,ATL,36,53,31,24.9,25,53,47.2,62.3,8.0,9,17,52.9,16.9,16,36,44.4
Semaj Christon,OKC,24,64,37,25.1,20,53,37.7,39.6,15.2,18,32,56.3,10.0,2,21,9.5
Amir Johnson,BOS,30,80,35,15.2,33,52,63.5,64.4,12.0,32,41,78.0,3.2,1,11,9.1
Tyler Ennis,LAL,22,53,26,27.1,25,52,48.1,60.6,13.0,12,25,48.0,14.1,13,27,48.1
Nemanja Bjelica,MIN,29,65,35,15.1,22,52,42.3,48.1,7.0,16,24,66.7,8.1,6,28,21.4
Paul Zipser,CHI,23,44,27,24.6,18,52,34.6,41.3,9.5,11,20,55.0,15.2,7,32,21.9
Tristan Thompson,CLE,26,78,37,13.0,36,51,70.6,70.6,12.8,36,50,72.0,0.3,0,1,0.0
Andre Roberson,OKC,25,79,37,11.9,28,51,54.9,57.8,8.2,25,35,71.4,3.7,3,16,18.8
David Lee,SAS,34,78,35,13.2,32,50,64.0,64.0,13.2,32,50,64.0,0.0,0,0,-
Bismack Biyombo,ORL,24,81,40,16.9,27,50,54.0,54.0,16.9,27,50,54.0,0.0,0,0,-
Patrick McCaw,GSW,21,71,33,22.0,23,50,46.0,56.0,8.4,13,19,68.4,13.7,10,31,32.3
Jose Calderon,ATL,35,41,25,38.5,20,50,40.0,46.0,20.8,14,27,51.9,17.7,6,23,26.1
Spencer Hawes,MIL,29,54,28,18.8,32,49,65.3,67.3,16.9,30,44,68.2,1.9,2,5,40.0
Ron Baker,NYK,24,52,29,24.4,16,49,32.7,37.8,11.4,11,23,47.8,12.9,5,26,19.2
Kay Felder,CLE,22,42,28,33.3,16,49,32.7,35.7,27.9,13,41,31.7,5.4,3,8,37.5
Rashad Vaughn,MIL,20,41,24,32.2,15,49,30.6,39.8,9.9,6,15,40.0,22.4,9,34,26.5
Brandon Bass,LAC,32,52,32,28.2,26,48,54.2,55.2,27.6,25,47,53.2,0.6,1,1,100
David West,GSW,36,68,37,19.7,24,48,50.0,50.0,18.9,24,46,52.2,0.8,0,2,0.0
Nicolas Brussino,DAL,24,54,25,35.3,16,48,33.3,43.8,10.3,6,14,42.9,25.0,10,34,29.4
JaVale McGee,GSW,29,77,36,15.1,31,46,67.4,67.4,14.8,31,45,68.9,0.3,0,1,0.0
Montrezl Harrell,HOU,23,58,32,15.0,27,46,58.7,58.7,14.1,27,43,62.8,1.0,0,3,0.0
Alec Burks,UTA,25,42,29,20.3,20,46,43.5,53.3,11.0,11,25,44.0,9.3,9,21,42.9
Bryn Forbes,SAS,23,35,19,48.4,16,46,34.8,40.2,24.2,11,23,47.8,24.2,5,23,21.7
Isaiah Canaan,CHI,26,39,27,27.7,14,46,30.4,37.0,9.0,8,15,53.3,18.7,6,31,19.4
Hollis Thompson,NOP,26,40,31,24.5,14,46,30.4,42.4,7.4,3,14,21.4,17.0,11,32,34.4
Shaun Livingston,GSW,31,76,32,14.7,28,45,62.2,62.2,14.7,28,45,62.2,0.0,0,0,-
Troy Williams,HOU,22,30,19,28.7,20,45,44.4,55.6,12.7,10,20,50.0,15.9,10,25,40.0
Thon Maker,MIL,20,57,31,26.6,19,45,42.2,50.0,12.4,12,21,57.1,14.2,7,24,29.2
Quincy Acy,BKN,26,38,25,27.6,16,45,35.6,45.6,9.8,7,16,43.8,17.8,9,29,31.0
Lance Stephenson,IND,26,18,16,37.0,19,44,43.2,44.3,31.1,18,37,48.6,5.9,1,7,14.3
Reggie Bullock,DET,26,31,24,35.8,16,44,36.4,47.7,9.8,6,12,50.0,26.0,10,32,31.3
Kenneth Faried,DEN,27,60,32,11.7,30,43,69.8,69.8,10.9,30,40,75.0,0.8,0,3,0.0
Skal Labissiere,SAC,21,33,20,21.3,28,43,65.1,65.1,20.8,28,42,66.7,0.5,0,1,0.0
Ivica Zubac,LAL,20,38,23,19.6,28,42,66.7,66.7,19.2,28,41,68.3,0.5,0,1,0.0
Noah Vonleh,POR,21,74,28,17.0,21,41,51.2,51.2,15.8,21,38,55.3,1.2,0,3,0.0
Kyle Anderson,SAS,23,71,32,21.4,18,41,43.9,48.8,16.7,14,32,43.8,4.7,4,9,44.4
Juancho Hernangomez,DEN,21,61,26,19.6,16,41,39.0,52.4,4.8,5,10,50.0,14.8,11,31,35.5
Dewayne Dedmon,SAS,27,75,32,16.8,24,39,61.5,61.5,16.8,24,39,61.5,0.0,0,0,-
Alan Williams,PHX,24,47,25,16.1,21,39,53.8,53.8,16.1,21,39,53.8,0.0,0,0,-
Brian Roberts,CHA,31,41,24,34.8,19,39,48.7,55.1,22.3,14,25,56.0,12.5,5,14,35.7
Pascal Siakam,TOR,23,54,30,21.2,17,39,43.6,43.6,20.1,17,37,45.9,1.1,0,2,0.0
Jonas Jerebko,BOS,30,78,31,15.5,21,38,55.3,63.2,8.6,15,21,71.4,6.9,6,17,35.3
Aron Baynes,DET,30,75,27,14.7,19,38,50.0,50.0,14.7,19,38,50.0,0.0,0,0,-
Justise Winslow,MIA,21,18,16,18.4,16,38,42.1,43.4,15.0,15,31,48.4,3.4,1,7,14.3
Brandon Rush,MIN,31,47,27,21.3,11,38,28.9,38.2,8.4,4,15,26.7,12.9,7,23,30.4
Dragan Bender,PHX,19,41,24,25.0,9,38,23.7,31.6,7.2,3,11,27.3,17.8,6,27,22.2
Zaza Pachulia,GSW,33,70,28,13.6,23,37,62.2,62.2,13.6,23,37,62.2,0.0,0,0,-
Darrun Hilliard,DET,24,39,20,30.8,17,37,45.9,52.7,15.8,12,19,63.2,15.0,5,18,27.8
Tyus Jones,MIN,21,60,27,20.9,16,37,43.2,54.1,9.0,8,16,50.0,11.9,8,21,38.1
Alexis Ajinca,NOP,29,39,20,21.2,19,35,54.3,54.3,21.2,19,35,54.3,0.0,0,0,-
Jordan McRae,CLE,26,37,21,26.3,14,35,40.0,42.9,16.5,12,22,54.5,9.8,2,13,15.4
Tarik Black,LAL,25,67,25,12.9,21,34,61.8,63.2,12.5,20,33,60.6,0.4,1,1,100
John Henson,MIL,26,58,27,11.7,17,34,50.0,50.0,11.7,17,34,50.0,0.0,0,0,-
Kris Humphries,ATL,32,56,21,16.8,15,34,44.1,45.6,14.9,14,30,46.7,2.0,1,4,25.0
Willie Reed,MIA,27,71,26,13.0,12,34,35.3,35.3,13.0,12,34,35.3,0.0,0,0,-
Jonathan Gibson,DAL,29,17,12,37.8,12,34,35.3,44.1,14.4,6,13,46.2,23.3,6,21,28.6
Cristiano Felicio,CHI,24,66,24,16.3,17,33,51.5,51.5,16.3,17,33,51.5,0.0,0,0,-
James Jones,CLE,36,48,22,36.3,14,33,42.4,56.1,11.0,5,10,50.0,25.3,9,23,39.1
Damjan Rudez,ORL,31,45,18,37.9,13,33,39.4,57.6,5.7,1,5,20.0,32.2,12,28,42.9
Kevin Seraphin,IND,27,48,23,16.8,18,31,58.1,58.1,16.2,18,30,60.0,0.5,0,1,0.0
Tyler Zeller,BOS,27,51,23,21.1,18,30,60.0,60.0,21.1,18,30,60.0,0.0,0,0,-
Toney Douglas,MEM,31,24,15,27.8,14,30,46.7,48.3,16.7,13,18,72.2,11.1,1,12,8.3
Tomas Satoransky,WAS,25,57,20,21.7,13,30,43.3,48.3,12.3,10,17,58.8,9.4,3,13,23.1
Paul Pierce,LAC,39,25,17,44.1,9,30,30.0,41.7,11.8,2,8,25.0,32.4,7,22,31.8
Jusuf Nurkic,POR,22,64,22,5.9,23,29,79.3,79.3,5.9,23,29,79.3,0.0,0,0,-
Omri Casspi,MIN,29,36,20,19.1,16,29,55.2,60.3,9.9,13,15,86.7,9.2,3,14,21.4
Jarell Martin,MEM,23,42,20,22.5,14,29,48.3,53.4,16.3,11,21,52.4,6.2,3,8,37.5
Chasson Randle,NYK,24,26,15,31.5,7,28,25.0,35.7,6.7,1,6,16.7,24.7,6,22,27.3
Joe Young,IND,25,32,13,42.2,14,27,51.9,59.3,26.6,10,17,58.8,15.6,4,10,40.0
Jake Layman,POR,23,35,17,31.8,6,27,22.2,29.6,10.6,2,9,22.2,21.2,4,18,22.2
Lavoy Allen,IND,28,60,21,16.8,15,26,57.7,57.7,16.1,15,25,60.0,0.6,0,1,0.0
Metta World Peace,LAL,37,25,12,40.0,7,26,26.9,30.8,20.0,5,13,38.5,20.0,2,13,15.4
Tyson Chandler,PHX,34,45,18,12.4,22,25,88.0,88.0,12.4,22,25,88.0,0.0,0,0,-
Maurice Ndour,NYK,25,32,19,33.3,15,25,60.0,60.0,30.7,15,23,65.2,2.7,0,2,0.0
Malachi Richardson,SAC,21,22,11,36.8,14,25,56.0,62.0,25.0,11,17,64.7,11.8,3,8,37.5
Alan Anderson,LAC,34,30,18,31.3,12,25,48.0,66.0,6.3,3,5,60.0,25.0,9,20,45.0
Cheick Diallo,NOP,20,17,12,34.2,9,25,36.0,36.0,34.2,9,25,36.0,0.0,0,0,-
Lucas Nogueira,TOR,24,56,19,16.7,18,24,75.0,75.0,16.0,18,23,78.3,0.7,0,1,0.0
Derrick Jones Jr.,PHX,20,32,14,20.9,14,24,58.3,60.4,19.1,13,22,59.1,1.7,1,2,50.0
KJ McDaniels,BKN,24,49,16,15.2,14,24,58.3,66.7,8.9,10,14,71.4,6.3,4,10,40.0
Thomas Robinson,LAL,26,48,15,13.3,10,24,41.7,41.7,13.3,10,24,41.7,0.0,0,0,-
Roy Hibbert,DEN,30,48,16,17.0,16,23,69.6,69.6,17.0,16,23,69.6,0.0,0,0,-
Delon Wright,TOR,25,27,14,22.3,14,23,60.9,69.6,15.5,10,16,62.5,6.8,4,7,57.1
Anthony Brown,ORL,24,11,10,46.9,10,23,43.5,50.0,20.4,7,10,70.0,26.5,3,13,23.1
Dejounte Murray,SAS,20,38,12,20.6,14,22,63.6,75.0,13.1,9,14,64.3,7.5,5,8,62.5
Quinn Cook,NOP,24,14,11,33.8,10,22,45.5,56.8,15.4,5,10,50.0,18.5,5,12,41.7
DeAndre Liggins,DAL,29,62,16,16.8,10,21,47.6,50.0,12.8,9,16,56.3,4.0,1,5,20.0
Wayne Selden,MEM,22,14,11,38.2,9,21,42.9,52.4,16.4,5,9,55.6,21.8,4,12,33.3
Andrew Nicholson,BKN,27,38,13,19.4,7,21,33.3,33.3,16.7,7,18,38.9,2.8,0,3,0.0
Marcelo Huertas,LAL,34,23,15,31.7,11,20,55.0,57.5,27.0,10,17,58.8,4.8,1,3,33.3
James Young,BOS,21,29,14,35.1,8,20,40.0,55.0,7.0,2,4,50.0,28.1,6,16,37.5
Sheldon Mac,WAS,24,30,14,28.2,7,20,35.0,37.5,19.7,6,14,42.9,8.5,1,6,16.7
Brandan Wright,MEM,29,28,13,15.3,14,19,73.7,73.7,14.5,14,18,77.8,0.8,0,1,0.0
Salah Mejri,DAL,31,72,16,15.1,13,19,68.4,68.4,14.3,13,18,72.2,0.8,0,1,0.0
James Michael McAdoo,GSW,24,52,17,17.8,11,19,57.9,57.9,15.9,11,17,64.7,1.9,0,2,0.0
DeAndre' Bembry,ATL,22,38,13,23.5,9,19,47.4,50.0,13.6,8,11,72.7,9.9,1,8,12.5
Raul Neto,UTA,25,40,13,23.5,8,19,42.1,47.4,14.8,6,12,50.0,8.6,2,7,28.6
Kyle Singler,OKC,29,32,11,24.4,8,19,42.1,44.7,16.7,7,13,53.8,7.7,1,6,16.7
Norris Cole,OKC,28,13,7,37.5,7,18,38.9,47.2,25.0,4,12,33.3,12.5,3,6,50.0
Pat Connaughton,POR,24,39,12,25.4,9,17,52.9,61.8,16.4,6,11,54.5,9.0,3,6,50.0
Donatas Motiejunas,NOP,26,34,11,12.9,8,17,47.1,52.9,9.1,6,12,50.0,3.8,2,5,40.0
Andrew Bogut,CLE,32,27,13,21.5,8,17,47.1,47.1,20.3,8,16,50.0,1.3,0,1,0.0
Josh McRoberts,MIA,30,22,12,16.2,7,17,41.2,44.1,13.3,6,14,42.9,2.9,1,3,33.3
Wade Baldwin IV,MEM,21,33,11,16.2,5,17,29.4,32.4,10.5,4,11,36.4,5.7,1,6,16.7
Luis Scola,BKN,37,35,15,11.9,6,16,37.5,50.0,4.5,2,6,33.3,7.5,4,10,40.0
Nicolas Laprovittola,SAS,27,18,8,35.6,6,16,37.5,50.0,8.9,2,4,50.0,26.7,4,12,33.3
Archie Goodwin,BKN,22,15,10,25.9,10,15,66.7,80.0,15.5,6,9,66.7,10.3,4,6,66.7
Bobby Brown,HOU,32,25,8,25.4,7,15,46.7,63.3,11.9,2,7,28.6,13.6,5,8,62.5
AJ Hammons,DAL,24,22,7,40.5,6,15,40.0,43.3,29.7,5,11,45.5,10.8,1,4,25.0
Fred VanVleet,TOR,23,36,10,15.8,5,15,33.3,33.3,10.5,5,10,50.0,5.3,0,5,0.0
Henry Ellenson,DET,20,19,10,24.2,1,15,6.7,6.7,8.1,1,5,20.0,16.1,0,10,0.0
Joakim Noah,NYK,32,46,13,7.4,9,14,64.3,64.3,7.4,9,14,64.3,0.0,0,0,-
Briante Weber,CHA,24,20,9,24.1,8,14,57.1,60.7,19.0,7,11,63.6,5.2,1,3,33.3
Adreian Payne,MIN,26,18,9,26.4,7,14,50.0,53.6,15.1,6,8,75.0,11.3,1,6,16.7
Malik Beasley,DEN,20,21,8,21.5,6,14,42.9,50.0,6.2,4,4,100,15.4,2,10,20.0
Anthony Bennett,BKN,24,22,9,17.9,5,14,35.7,42.9,7.7,3,6,50.0,10.3,2,8,25.0
Mike Scott,ATL,28,18,10,25.5,5,14,35.7,39.3,18.2,4,10,40.0,7.3,1,4,25.0
Shawn Long,PHI,24,18,8,13.0,8,13,61.5,69.2,10.0,6,10,60.0,3.0,2,3,66.7
Georgios Papagiannis,SAC,19,22,8,13.0,8,13,61.5,61.5,13.0,8,13,61.5,0.0,0,0,-
Kevon Looney,GSW,21,53,11,11.8,7,11,63.6,68.2,9.7,6,9,66.7,2.2,1,2,50.0
Miles Plumlee,CHA,28,45,11,13.8,7,11,63.6,63.6,13.8,7,11,63.6,0.0,0,0,-
Cole Aldrich,MIN,28,62,9,13.9,7,11,63.6,63.6,13.9,7,11,63.6,0.0,0,0,-
Ronnie Price,PHX,34,14,5,50.0,3,11,27.3,36.4,9.1,1,2,50.0,40.9,2,9,22.2
Okaro White,MIA,24,35,11,14.1,3,11,27.3,31.8,9.0,2,7,28.6,5.1,1,4,25.0
Ian Mahinmi,WAS,30,31,6,9.9,9,10,90.0,90.0,9.9,9,10,90.0,0.0,0,0,-
Jakob Poeltl,TOR,21,53,10,9.7,8,10,80.0,80.0,9.7,8,10,80.0,0.0,0,0,-
Pierre Jackson,DAL,25,9,4,27.0,3,10,30.0,35.0,13.5,2,5,40.0,13.5,1,5,20.0
David Nwaba,LAL,24,20,7,12.5,7,9,77.8,77.8,12.5,7,9,77.8,0.0,0,0,-
Ed Davis,POR,28,46,9,7.4,7,9,77.8,77.8,7.4,7,9,77.8,0.0,0,0,-
Jeff Withey,UTA,27,51,9,10.2,6,9,66.7,66.7,10.2,6,9,66.7,0.0,0,0,-
Jerryd Bayless,PHI,28,3,3,32.1,3,9,33.3,38.9,21.4,2,6,33.3,10.7,1,3,33.3
Georges Niang,IND,24,22,7,32.1,1,9,11.1,11.1,17.9,1,5,20.0,14.3,0,4,0.0
Jared Sullinger,TOR,25,11,7,20.9,1,9,11.1,16.7,11.6,0,5,0.0,9.3,1,4,25.0
Johnny O'Bryant III,CHA,24,11,4,26.7,6,8,75.0,87.5,20.0,4,6,66.7,6.7,2,2,100
Boban Marjanovic,DET,28,35,5,5.8,6,7,85.7,85.7,5.8,6,7,85.7,0.0,0,0,-
Tim Quarterman,POR,22,16,5,26.9,4,7,57.1,64.3,15.4,3,4,75.0,11.5,1,3,33.3
Treveon Graham,CHA,23,27,5,21.2,4,7,57.1,57.1,18.2,4,6,66.7,3.0,0,1,0.0
Rakeem Christmas,IND,25,29,6,18.9,3,7,42.9,42.9,18.9,3,7,42.9,0.0,0,0,-
Damian Jones,GSW,22,10,5,46.7,2,7,28.6,28.6,46.7,2,7,28.6,0.0,0,0,-
Stephen Zimmerman,ORL,20,19,5,29.2,1,7,14.3,14.3,29.2,1,7,14.3,0.0,0,0,-
Omer Asik,NOP,30,31,6,11.5,6,6,100.0,100.0,11.5,6,6,100,0.0,0,0,-
Ryan Kelly,ATL,26,16,5,23.1,3,6,50.0,58.3,19.2,2,5,40.0,3.8,1,1,100
Nick Collison,OKC,36,20,6,26.1,3,6,50.0,50.0,26.1,3,6,50.0,0.0,0,0,-
Justin Harper,PHI,27,3,2,54.5,2,6,33.3,33.3,18.2,2,2,100,36.4,0,4,0.0
Deyonta Davis,MEM,20,36,5,13.0,2,6,33.3,33.3,13.0,2,6,33.3,0.0,0,0,-
Jarrod Uthoff,DAL,24,9,3,13.9,4,5,80.0,80.0,13.9,4,5,80.0,0.0,0,0,-
Mike Miller,DEN,37,19,4,22.7,3,5,60.0,90.0,0.0,0,0,-,22.7,3,5,60.0
Bruno Caboclo,TOR,21,8,2,33.3,3,5,60.0,70.0,13.3,2,2,100,20.0,1,3,33.3
Alex Poythress,PHI,23,6,4,10.0,2,5,40.0,60.0,2.0,0,1,0.0,8.0,2,4,50.0
C.J. Wilcox,ORL,26,22,5,16.1,2,5,40.0,40.0,12.9,2,4,50.0,3.2,0,1,0.0
Steve Novak,MIL,34,8,5,71.4,1,5,20.0,20.0,14.3,1,1,100,57.1,0,4,0.0
Gary Neal,ATL,32,2,2,71.4,0,5,0.0,0.0,42.9,0,3,0.0,28.6,0,2,0.0
Kyle Wiltjer,HOU,24,14,4,35.7,0,5,0.0,0.0,7.1,0,1,0.0,28.6,0,4,0.0
Manny Harris,DAL,27,4,3,41.7,0,5,0.0,0.0,25.0,0,3,0.0,16.7,0,2,0.0
Jordan Mickey,BOS,22,25,4,14.3,3,4,75.0,75.0,14.3,3,4,75.0,0.0,0,0,-
Jordan Farmar,SAC,30,2,2,36.4,3,4,75.0,112.5,0.0,0,0,-,36.4,3,4,75.0
Chris McCullough,WAS,22,16,4,13.8,2,4,50.0,50.0,13.8,2,4,50.0,0.0,0,0,-
Udonis Haslem,MIA,37,16,4,18.2,1,4,25.0,25.0,13.6,1,3,33.3,4.5,0,1,0.0
Jarell Eddie,PHX,25,5,3,21.1,1,4,25.0,37.5,0.0,0,0,-,21.1,1,4,25.0
Daniel Ochefu,WAS,23,19,4,17.4,0,4,0.0,0.0,17.4,0,4,0.0,0.0,0,0,-
Reggie Williams,NOP,30,6,3,17.4,0,4,0.0,0.0,13.0,0,3,0.0,4.3,0,1,0.0
Joel Anthony,SAS,34,19,2,20.0,3,3,100.0,100.0,20.0,3,3,100,0.0,0,0,-
Josh Huestis,OKC,25,2,2,27.3,1,3,33.3,33.3,18.2,1,2,50.0,9.1,0,1,0.0
Gary Payton II,MIL,24,6,3,15.8,0,3,0.0,0.0,0.0,0,0,-,15.8,0,3,0.0
Michael Gbinije,DET,25,9,3,30.0,0,3,0.0,0.0,10.0,0,1,0.0,20.0,0,2,0.0
Diamond Stone,LAC,20,7,2,20.0,1,2,50.0,50.0,20.0,1,2,50.0,0.0,0,0,-
Brice Johnson,LAC,23,3,2,33.3,1,2,50.0,50.0,33.3,1,2,50.0,0.0,0,0,-
Chinanu Onuaku,HOU,20,5,2,28.6,1,2,50.0,50.0,28.6,1,2,50.0,0.0,0,0,-
John Lucas III,MIN,34,5,1,50.0,1,2,50.0,50.0,50.0,1,2,50.0,0.0,0,0,-
Anderson Varejao,GSW,34,14,2,14.3,1,2,50.0,50.0,14.3,1,2,50.0,0.0,0,0,-
Dahntay Jones,CLE,36,1,1,28.6,1,2,50.0,50.0,14.3,1,1,100,14.3,0,1,0.0
John Jenkins,PHX,26,4,2,40.0,0,2,0.0,0.0,20.0,0,1,0.0,20.0,0,1,0.0
Lamar Patterson,ATL,25,5,2,15.4,0,2,0.0,0.0,0.0,0,0,-,15.4,0,2,0.0
Aaron Harrison,CHA,22,5,2,50.0,0,2,0.0,0.0,25.0,0,1,0.0,25.0,0,1,0.0
Alonzo Gee,DEN,30,13,2,16.7,0,2,0.0,0.0,16.7,0,2,0.0,0.0,0,0,-
Tiago Splitter,PHI,32,8,1,3.8,1,1,100.0,100.0,3.8,1,1,100,0.0,0,0,-
Edy Tavares,CLE,25,2,1,20.0,1,1,100.0,100.0,20.0,1,1,100,0.0,0,0,-
Jarrett Jack,NOP,33,2,1,33.3,1,1,100.0,100.0,33.3,1,1,100,0.0,0,0,-
Chris Andersen,CLE,38,12,1,5.0,1,1,100.0,100.0,5.0,1,1,100,0.0,0,0,-
Axel Toupane,NOP,24,4,1,11.1,1,1,100.0,150.0,0.0,0,0,-,11.1,1,1,100
Joel Bolomboy,UTA,23,12,1,6.7,0,1,0.0,0.0,6.7,0,1,0.0,0.0,0,0,-
Greivis Vasquez,BKN,30,3,1,14.3,0,1,0.0,0.0,0.0,0,0,-,14.3,0,1,0.0
Marshall Plumlee,NYK,24,21,1,4.0,0,1,0.0,0.0,4.0,0,1,0.0,0.0,0,0,-
Arinze Onuaku,ORL,29,8,1,25.0,0,1,0.0,0.0,25.0,0,1,0.0,0.0,0,0,-
Isaiah Taylor,HOU,22,4,1,14.3,0,1,0.0,0.0,0.0,0,0,-,14.3,0,1,0.0
Patricio Garino,ORL,24,5,1,14.3,0,1,0.0,0.0,0.0,0,0,-,14.3,0,1,0.0
Jordan Hill,MIN,29,7,1,8.3,0,1,0.0,0.0,8.3,0,1,0.0,0.0,0,0,-
Demetrius Jackson,BOS,22,5,1,25.0,0,1,0.0,0.0,25.0,0,1,0.0,0.0,0,0,-
