PLAYER,TEAM,AGE,GP,G,FREQ%,FGM,FGA,FG%,EFG%,2FG FREQ%,2FGM,2FGA,2FG%,3FG FREQ%,3PM,3PA,3P%
Zion Williamson,NOP,20,61,61,64.7,413,671,61.5,61.5,64.7,413,671,61.5,0.0,0,0,-
Nikola Jokic,DEN,26,72,72,52.3,387,667,58.0,58.7,49.8,378,635,59.5,2.5,9,32,28.1
Bradley Beal,WAS,28,60,60,45.7,315,632,49.8,51.7,40.2,291,555,52.4,5.6,24,77,31.2
Jayson Tatum,BOS,23,64,64,45.6,280,601,46.6,51.0,33.6,227,443,51.2,12.0,53,158,33.5
Devin Booker,PHX,24,67,67,46.3,298,589,50.6,52.3,41.0,278,522,53.3,5.3,20,67,29.9
Stephen Curry,GSW,33,63,62,42.7,280,580,48.3,55.4,26.2,197,355,55.5,16.6,83,225,36.9
Brandon Ingram,NOP,23,61,61,49.2,269,541,49.7,53.4,39.6,229,436,52.5,9.5,40,105,38.1
Damian Lillard,POR,30,67,67,40.1,248,535,46.4,53.2,24.9,175,332,52.7,15.2,73,203,36.0
Collin Sexton,CLE,22,60,59,48.5,262,528,49.6,50.4,45.8,254,498,51.0,2.8,8,30,26.7
Giannis Antetokounmpo,MIL,26,61,60,47.4,334,521,64.1,64.1,47.3,334,520,64.2,0.1,0,1,0.0
Nikola Vucevic,CHI,30,70,69,36.6,267,511,52.3,52.4,36.1,265,505,52.5,0.4,2,6,33.3
Luka Doncic,DAL,22,66,66,37.7,267,507,52.7,54.1,32.4,252,436,57.8,5.3,15,71,21.1
DeMar DeRozan,SAS,31,61,61,54.5,244,500,48.8,48.8,53.5,244,491,49.7,1.0,0,9,0.0
Jordan Clarkson,UTA,29,68,67,45.7,216,490,44.1,48.3,31.3,175,336,52.1,14.4,41,154,26.6
Kyrie Irving,BKN,29,54,54,44.3,244,481,50.7,52.8,37.8,224,410,54.6,6.5,20,71,28.2
Tobias Harris,PHI,28,62,62,51.9,264,480,55.0,55.9,50.0,255,462,55.2,1.9,9,18,50.0
De'Aaron Fox,SAC,23,58,58,43.2,259,479,54.1,55.1,38.9,249,432,57.6,4.2,10,47,21.3
Russell Westbrook,WAS,32,65,65,38.7,249,479,52.0,52.3,37.6,246,466,52.8,1.1,3,13,23.1
Julius Randle,NYK,26,71,71,36.3,222,479,46.3,48.3,32.8,203,433,46.9,3.5,19,46,41.3
Ja Morant,MEM,21,63,63,49.6,232,475,48.8,49.1,48.2,230,461,49.9,1.5,2,14,14.3
Jaylen Brown,BOS,24,58,58,42.7,248,474,52.3,55.6,35.7,217,396,54.8,7.0,31,78,39.7
Clint Capela,ATL,27,63,63,67.1,266,466,57.1,57.1,67.1,266,466,57.1,0.0,0,0,-
Trae Young,ATL,22,63,63,41.4,226,460,49.1,49.3,39.9,224,443,50.6,1.5,2,17,11.8
RJ Barrett,NYK,21,72,72,43.9,215,460,46.7,47.4,41.8,209,439,47.6,2.0,6,21,28.6
Terry Rozier,CHA,27,69,69,40.5,198,459,43.1,48.1,29.4,152,333,45.6,11.1,46,126,36.5
Domantas Sabonis,IND,25,62,61,50.2,266,454,58.6,59.0,49.6,262,448,58.5,0.7,4,6,66.7
Jonas Valanciunas,MEM,29,62,62,60.8,277,451,61.4,61.5,60.6,276,450,61.3,0.1,1,1,100
Thaddeus Young,CHI,33,68,67,67.9,260,450,57.8,57.8,67.9,260,450,57.8,0.0,0,0,-
Donovan Mitchell,UTA,24,53,53,41.1,204,448,45.5,48.3,34.3,179,374,47.9,6.8,25,74,33.8
Anthony Edwards,MIN,19,72,71,36.6,209,442,47.3,49.2,31.1,192,376,51.1,5.5,17,66,25.8
Zach LaVine,CHI,26,58,58,38.3,235,430,54.7,58.5,29.4,202,330,61.2,8.9,33,100,33.0
Khris Middleton,MIL,29,68,67,39.9,197,429,45.9,49.0,33.1,171,355,48.2,6.9,26,74,35.1
Pascal Siakam,TOR,27,56,55,43.8,215,421,51.1,51.2,43.3,214,416,51.4,0.5,1,5,20.0
Jimmy Butler,MIA,31,52,52,55.5,215,409,52.6,52.9,52.6,212,388,54.6,2.8,3,21,14.3
Bam Adebayo,MIA,23,64,64,51.1,248,408,60.8,60.9,50.3,247,402,61.4,0.8,1,6,16.7
Andrew Wiggins,GSW,26,71,71,38.9,213,408,52.2,53.3,35.4,204,372,54.8,3.4,9,36,25.0
Dejounte Murray,SAS,24,67,65,40.9,191,398,48.0,49.0,39.1,183,380,48.2,1.8,8,18,44.4
Dillon Brooks,MEM,25,67,66,38.6,170,398,42.7,43.3,36.4,165,375,44.0,2.2,5,23,21.7
Kawhi Leonard,LAC,30,52,52,43.4,210,394,53.3,55.1,38.8,196,352,55.7,4.6,14,42,33.3
Deandre Ayton,PHX,22,69,69,57.6,259,392,66.1,66.1,57.6,259,392,66.1,0.0,0,0,-
Norman Powell,POR,28,69,69,42.5,202,390,51.8,55.1,35.3,176,324,54.3,7.2,26,66,39.4
Rudy Gobert,UTA,29,71,71,67.3,255,389,65.6,65.6,67.1,255,388,65.7,0.2,0,1,0.0
Jerami Grant,DET,27,54,54,41.1,174,379,45.9,47.5,36.7,162,338,47.9,4.4,12,41,29.3
Andre Drummond,LAL,27,46,45,68.5,185,378,48.9,48.9,68.5,185,378,48.9,0.0,0,0,-
Carmelo Anthony,POR,37,69,69,48.5,153,377,40.6,45.6,36.8,115,286,40.2,11.7,38,91,41.8
Ben Simmons,PHI,24,58,58,64.5,193,376,51.3,51.5,64.0,192,373,51.5,0.5,1,3,33.3
Paul George,LAC,31,54,54,39.1,177,373,47.5,51.6,28.5,146,272,53.7,10.6,31,101,30.7
John Collins,ATL,23,63,60,47.3,234,365,64.1,64.4,46.4,232,358,64.8,0.9,2,7,28.6
Enes Freedom,POR,29,72,71,64.9,220,364,60.4,60.4,64.9,220,364,60.4,0.0,0,0,-
Malcolm Brogdon,IND,28,56,55,37.0,184,362,50.8,52.1,34.5,175,338,51.8,2.5,9,24,37.5
Karl-Anthony Towns,MIN,25,50,50,41.3,196,361,54.3,54.6,40.2,194,352,55.1,1.0,2,9,22.2
Joel Embiid,PHI,27,51,51,39.7,194,357,54.3,54.6,38.1,192,343,56.0,1.6,2,14,14.3
Michael Porter Jr.,DEN,23,61,60,44.0,174,357,48.7,55.5,28.0,126,227,55.5,16.0,48,130,36.9
James Harden,BKN,31,44,42,48.4,176,356,49.4,52.8,38.6,152,284,53.5,9.8,24,72,33.3
Tim Hardaway Jr.,DAL,29,70,69,38.6,163,351,46.4,52.1,26.3,123,239,51.5,12.3,40,112,35.7
Bojan Bogdanovic,UTA,32,72,70,36.8,166,340,48.8,51.2,32.1,150,296,50.7,4.8,16,44,36.4
Kevin Durant,BKN,32,35,35,56.1,185,338,54.7,60.5,43.3,146,261,55.9,12.8,39,77,50.6
Keldon Johnson,SAS,21,69,69,47.9,179,338,53.0,53.1,47.1,178,332,53.6,0.9,1,6,16.7
Dennis Schroder,LAL,27,61,59,44.3,150,333,45.0,45.3,43.0,148,323,45.8,1.3,2,10,20.0
Montrezl Harrell,LAL,27,69,66,55.9,211,332,63.6,63.6,55.9,211,332,63.6,0.0,0,0,-
Josh Jackson,DET,24,62,62,47.3,147,332,44.3,46.1,41.2,135,289,46.7,6.1,12,43,27.9
Elfrid Payton,NYK,27,63,63,53.2,149,327,45.6,45.6,52.8,149,325,45.8,0.3,0,2,0.0
Jrue Holiday,MIL,31,59,59,38.7,164,319,51.4,52.4,36.2,158,298,53.0,2.5,6,21,28.6
CJ McCollum,POR,29,47,47,35.6,144,315,45.7,49.8,26.5,118,234,50.4,9.2,26,81,32.1
Darius Garland,CLE,21,54,52,39.8,142,315,45.1,45.6,38.0,139,301,46.2,1.8,3,14,21.4
Terrence Ross,ORL,30,46,46,51.1,130,315,41.3,46.7,30.8,96,190,50.5,20.3,34,125,27.2
Dwayne Bacon,ORL,25,72,71,43.2,145,313,46.3,47.1,42.1,140,305,45.9,1.1,5,8,62.5
Derrick Rose,NYK,32,50,50,51.3,142,310,45.8,46.3,47.4,139,286,48.6,4.0,3,24,12.5
Caris LeVert,IND,26,47,47,37.8,153,308,49.7,50.2,36.2,150,295,50.8,1.6,3,13,23.1
Jarrett Allen,CLE,23,63,61,63.9,192,306,62.7,62.7,63.9,192,306,62.7,0.0,0,0,-
Doug McDermott,IND,29,66,66,45.7,172,304,56.6,59.5,38.0,154,253,60.9,7.7,18,51,35.3
Robin Lopez,WAS,33,71,67,71.2,201,302,66.6,66.6,71.2,201,302,66.6,0.0,0,0,-
Shake Milton,PHI,24,63,62,45.3,135,302,44.7,45.5,41.4,130,276,47.1,3.9,5,26,19.2
Fred VanVleet,TOR,27,52,52,34.7,114,302,37.7,41.4,26.3,92,229,40.2,8.4,22,73,30.1
Jae'Sean Tate,HOU,25,70,70,48.5,187,301,62.1,62.3,48.1,186,298,62.4,0.5,1,3,33.3
Duncan Robinson,MIA,27,72,72,41.7,126,299,42.1,56.7,9.5,39,68,57.4,32.2,87,231,37.7
Christian Wood,HOU,25,41,41,46.3,173,296,58.4,58.8,44.5,171,285,60.0,1.7,2,11,18.2
Tyler Herro,MIA,21,54,53,42.3,144,296,48.6,51.5,33.9,127,237,53.6,8.4,17,59,28.8
Coby White,CHI,21,69,69,32.6,136,294,46.3,47.6,29.8,128,269,47.6,2.8,8,25,32.0
Kelly Oubre Jr.,GSW,25,55,54,40.7,143,292,49.0,49.3,39.0,141,280,50.4,1.7,2,12,16.7
Gary Trent Jr.,TOR,22,58,56,36.7,104,288,36.1,40.6,25.4,78,199,39.2,11.3,26,89,29.2
P.J. Washington,CHA,22,64,60,41.7,132,286,46.2,46.5,40.1,130,275,47.3,1.6,2,11,18.2
Kristaps Porzingis,DAL,25,43,43,41.7,145,285,50.9,52.5,38.5,136,263,51.7,3.2,9,22,40.9
Harrison Barnes,SAC,29,58,57,44.1,153,283,54.1,54.6,41.9,150,269,55.8,2.2,3,14,21.4
Brandon Clarke,MEM,24,59,59,56.7,158,280,56.4,56.6,56.3,157,278,56.5,0.4,1,2,50.0
Anthony Davis,LAL,28,36,35,46.9,155,280,55.4,55.5,45.6,154,272,56.6,1.3,1,8,12.5
Jalen Brunson,DAL,24,68,67,44.2,158,277,57.0,58.1,42.3,152,265,57.4,1.9,6,12,50.0
Naz Reid,MIN,21,70,67,47.2,155,274,56.6,56.6,46.8,155,272,57.0,0.3,0,2,0.0
Bobby Portis,MIL,26,66,66,45.4,140,272,51.5,52.0,43.9,137,263,52.1,1.5,3,9,33.3
Buddy Hield,SAC,28,71,71,27.3,108,271,39.9,48.9,13.7,59,136,43.4,13.6,49,135,36.3
LeBron James,LAL,36,45,44,33.8,156,269,58.0,59.1,30.2,150,240,62.5,3.6,6,29,20.7
Richaun Holmes,SAC,27,61,61,45.7,172,263,65.4,65.4,45.7,172,263,65.4,0.0,0,0,-
Darius Bazley,OKC,21,55,55,37.4,114,258,44.2,44.2,36.4,114,251,45.4,1.0,0,7,0.0
Kemba Walker,BOS,31,43,43,38.2,106,258,41.1,48.4,21.3,68,144,47.2,16.9,38,114,33.3
Chris Paul,PHX,36,70,67,29.1,125,253,49.4,50.4,25.1,120,218,55.0,4.0,5,35,14.3
Joe Harris,BKN,29,69,68,35.7,115,252,45.6,52.2,21.4,82,151,54.3,14.3,33,101,32.7
LaMelo Ball,CHA,19,51,49,37.3,107,251,42.6,42.6,36.0,107,242,44.2,1.3,0,9,0.0
Marvin Bagley III,SAC,22,43,43,51.1,128,250,51.2,51.4,50.7,127,248,51.2,0.4,1,2,50.0
Cole Anthony,ORL,21,47,47,45.3,99,250,39.6,40.6,42.4,94,234,40.2,2.9,5,16,31.3
Shai Gilgeous-Alexander,OKC,22,35,35,44.1,140,249,56.2,58.8,40.4,127,228,55.7,3.7,13,21,61.9
Lou Williams,ATL,34,66,63,38.2,100,247,40.5,43.1,32.5,87,210,41.4,5.7,13,37,35.1
Ivica Zubac,LAC,24,72,69,61.9,160,244,65.6,65.6,61.7,160,243,65.8,0.3,0,1,0.0
Hamidou Diallo,DET,22,52,52,51.9,125,244,51.2,51.2,51.3,125,241,51.9,0.6,0,3,0.0
John Wall,HOU,30,40,40,33.2,117,241,48.5,48.5,32.8,117,238,49.2,0.4,0,3,0.0
Jakob Poeltl,SAS,25,69,66,55.5,150,239,62.8,62.8,55.5,150,239,62.8,0.0,0,0,-
Kelly Olynyk,HOU,30,70,62,34.1,146,237,61.6,62.4,31.3,142,218,65.1,2.7,4,19,21.1
Rudy Gay,SAS,34,63,60,37.7,92,237,38.8,40.7,32.8,83,206,40.3,4.9,9,31,29.0
Kyle Anderson,MEM,27,69,67,35.6,126,234,53.8,54.7,33.7,122,222,55.0,1.8,4,12,33.3
Malik Beasley,MIN,24,37,36,38.8,100,233,42.9,46.8,27.3,82,164,50.0,11.5,18,69,26.1
Bruce Brown,BKN,24,65,55,54.6,129,231,55.8,55.8,53.4,129,226,57.1,1.2,0,5,0.0
Jamal Murray,DEN,24,48,48,29.4,121,231,52.4,54.3,25.1,112,197,56.9,4.3,9,34,26.5
Will Barton,DEN,30,56,54,38.2,102,231,44.2,44.8,35.9,99,217,45.6,2.3,3,14,21.4
Luguentz Dort,OKC,22,52,51,35.9,90,229,39.3,40.6,31.3,84,200,42.0,4.5,6,29,20.7
Immanuel Quickley,NYK,22,64,61,39.2,87,226,38.5,40.9,32.6,76,188,40.4,6.6,11,38,28.9
Mason Plumlee,DET,31,56,55,59.1,145,224,64.7,64.7,59.1,145,224,64.7,0.0,0,0,-
Tristan Thompson,BOS,30,54,51,68.4,107,223,48.0,48.0,68.1,107,222,48.2,0.3,0,1,0.0
Kevin Huerter,ATL,22,69,68,30.5,100,223,44.8,46.4,27.5,93,201,46.3,3.0,7,22,31.8
Isaiah Stewart,DET,20,68,67,54.8,135,222,60.8,60.8,54.8,135,222,60.8,0.0,0,0,-
Delon Wright,SAC,29,63,58,43.8,117,222,52.7,52.7,42.4,117,215,54.4,1.4,0,7,0.0
Rui Hachimura,WAS,23,57,55,34.3,114,222,51.4,51.6,33.5,113,217,52.1,0.8,1,5,20.0
Eric Bledsoe,NOP,31,71,63,30.4,100,222,45.0,45.7,28.2,97,206,47.1,2.2,3,16,18.8
Brook Lopez,MIL,33,70,64,34.5,141,221,63.8,64.3,34.1,139,218,63.8,0.5,2,3,66.7
Kyle Kuzma,LAL,25,68,65,29.4,113,221,51.1,52.9,25.4,105,191,55.0,4.0,8,30,26.7
Gordon Hayward,CHA,31,44,43,33.4,110,220,50.0,50.7,31.0,107,204,52.5,2.4,3,16,18.8
Patrick Williams,CHI,19,71,68,41.5,120,219,54.8,55.3,41.1,118,217,54.4,0.4,2,2,100
Isaiah Roby,OKC,23,61,58,51.7,109,219,49.8,49.8,50.5,109,214,50.9,1.2,0,5,0.0
Isaac Okoro,CLE,20,67,60,39.6,112,218,51.4,51.6,38.5,111,212,52.4,1.1,1,6,16.7
Wendell Carter Jr.,ORL,22,54,54,47.5,123,217,56.7,56.7,47.5,123,217,56.7,0.0,0,0,-
Kendrick Nunn,MIA,25,56,55,32.8,119,216,55.1,55.6,30.4,117,200,58.5,2.4,2,16,12.5
D'Angelo Russell,MIN,25,42,41,33.0,87,215,40.5,43.3,23.9,75,156,48.1,9.0,12,59,20.3
Chris Boucher,TOR,28,60,57,37.9,132,212,62.3,63.0,35.2,129,197,65.5,2.7,3,15,20.0
Josh Richardson,DAL,27,59,56,34.3,99,212,46.7,47.9,29.8,94,184,51.1,4.5,5,28,17.9
Theo Maledon,OKC,20,65,59,34.6,69,212,32.5,33.0,31.5,67,193,34.7,3.1,2,19,10.5
Goran Dragic,MIA,35,50,49,37.7,99,209,47.4,49.8,32.1,89,178,50.0,5.6,10,31,32.3
Tyrese Maxey,PHI,20,61,52,48.5,100,208,48.1,48.1,47.1,100,202,49.5,1.4,0,6,0.0
Victor Oladipo,MIA,29,33,32,36.9,99,208,47.6,50.0,31.9,89,180,49.4,5.0,10,28,35.7
Evan Fournier,BOS,28,42,41,38.3,101,207,48.8,54.6,26.1,77,141,54.6,12.2,24,66,36.4
Kyle Lowry,TOR,35,46,45,34.7,86,207,41.5,46.6,22.5,65,134,48.5,12.2,21,73,28.8
Miles Bridges,CHA,23,66,62,32.6,125,203,61.6,62.1,31.4,123,195,63.1,1.3,2,8,25.0
Jusuf Nurkic,POR,26,37,37,60.4,107,201,53.2,53.2,60.4,107,201,53.2,0.0,0,0,-
T.J. McConnell,IND,29,69,67,40.8,106,200,53.0,53.0,40.8,106,200,53.0,0.0,0,0,-
Dwight Howard,PHI,35,69,61,65.0,119,197,60.4,60.4,65.0,119,197,60.4,0.0,0,0,-
Cody Zeller,CHA,28,48,47,60.8,115,197,58.4,58.4,60.8,115,197,58.4,0.0,0,0,-
Jeff Green,BKN,34,68,65,37.2,106,197,53.8,54.8,34.5,102,183,55.7,2.6,4,14,28.6
Steven Adams,NOP,27,58,54,63.8,120,196,61.2,61.2,63.5,120,195,61.5,0.3,0,1,0.0
Lonnie Walker IV,SAS,22,60,58,32.2,82,196,41.8,42.6,29.2,79,178,44.4,3.0,3,18,16.7
Mike Conley,UTA,33,51,50,30.6,86,195,44.1,45.9,27.6,79,176,44.9,3.0,7,19,36.8
Reggie Jackson,LAC,31,67,56,33.6,85,195,43.6,45.4,30.3,78,176,44.3,3.3,7,19,36.8
Devonte' Graham,CHA,26,55,54,29.2,64,195,32.8,41.0,13.9,32,93,34.4,15.3,32,102,31.4
Cedi Osman,CLE,26,59,54,33.2,81,191,42.4,43.5,28.2,77,162,47.5,5.0,4,29,13.8
Mikal Bridges,PHX,24,72,68,28.9,121,190,63.7,64.7,26.8,117,176,66.5,2.1,4,14,28.6
Talen Horton-Tucker,LAL,20,65,62,38.9,98,190,51.6,51.6,38.1,98,186,52.7,0.8,0,4,0.0
Marcus Morris Sr.,LAC,31,57,55,32.4,76,189,40.2,43.4,25.2,64,147,43.5,7.2,12,42,28.6
Aaron Gordon,DEN,25,50,49,37.7,97,188,51.6,52.9,33.9,92,169,54.4,3.8,5,19,26.3
Tyus Jones,MEM,25,70,66,45.0,94,186,50.5,51.1,43.1,92,178,51.7,1.9,2,8,25.0
Willy Hernangomez,NOP,27,47,42,69.3,106,185,57.3,57.3,68.9,106,184,57.6,0.4,0,1,0.0
James Wiseman,GSW,20,39,39,51.2,103,185,55.7,55.7,51.2,103,185,55.7,0.0,0,0,-
Tyrese Haliburton,SAC,21,58,57,29.6,96,183,52.5,52.7,29.2,95,181,52.5,0.3,1,2,50.0
Donte DiVincenzo,MIL,24,66,65,30.3,82,183,44.8,46.4,27.0,76,163,46.6,3.3,6,20,30.0
Patty Mills,SAS,32,68,64,29.7,82,182,45.1,53.6,15.4,51,94,54.3,14.4,31,88,35.2
Svi Mykhailiuk,OKC,24,66,58,35.2,80,178,44.9,52.5,20.6,53,104,51.0,14.6,27,74,36.5
Seth Curry,PHI,30,57,55,32.1,84,177,47.5,54.0,21.7,61,120,50.8,10.3,23,57,40.4
Alec Burks,NYK,29,49,44,35.8,69,177,39.0,41.8,28.9,59,143,41.3,6.9,10,34,29.4
O.G. Anunoby,TOR,23,43,42,33.8,94,175,53.7,55.7,30.3,87,157,55.4,3.5,7,18,38.9
Bogdan Bogdanovic,ATL,28,44,40,30.8,88,174,50.6,56.9,21.8,66,123,53.7,9.0,22,51,43.1
Raul Neto,WAS,29,64,60,38.7,85,173,49.1,49.1,37.4,85,167,50.9,1.3,0,6,0.0
Paul Millsap,DEN,36,56,54,43.4,96,172,55.8,56.1,42.2,95,167,56.9,1.3,1,5,20.0
Cory Joseph,DET,29,63,56,40.1,91,171,53.2,53.5,38.7,90,165,54.5,1.4,1,6,16.7
Saddiq Bey,DET,22,70,60,24.9,68,171,39.8,42.7,20.6,58,142,40.8,4.2,10,29,34.5
Jaxson Hayes,NOP,21,60,54,60.4,109,169,64.5,64.5,60.4,109,169,64.5,0.0,0,0,-
Lauri Markkanen,CHI,24,51,45,32.5,99,169,58.6,59.5,30.8,96,160,60.0,1.7,3,9,33.3
Kenrich Williams,OKC,26,66,58,40.9,98,168,58.3,58.6,39.7,97,163,59.5,1.2,1,5,20.0
Aaron Holiday,IND,24,66,58,38.4,68,168,40.5,40.5,37.5,68,164,41.5,0.9,0,4,0.0
Bismack Biyombo,CHA,28,66,61,69.0,96,167,57.5,57.5,69.0,96,167,57.5,0.0,0,0,-
DeAndre Jordan,BKN,32,57,53,66.7,125,166,75.3,75.3,66.3,125,165,75.8,0.4,0,1,0.0
JaVale McGee,DEN,33,46,45,59.8,83,165,50.3,50.3,58.7,83,162,51.2,1.1,0,3,0.0
Alex Len,WAS,28,64,52,59.0,107,164,65.2,65.2,58.6,107,163,65.6,0.4,0,1,0.0
Myles Turner,IND,25,47,46,38.0,98,164,59.8,60.4,37.0,96,160,60.0,0.9,2,4,50.0
Marcus Smart,BOS,27,48,46,32.0,71,163,43.6,46.6,24.7,61,126,48.4,7.3,10,37,27.0
Davis Bertans,WAS,28,57,56,34.1,70,163,42.9,58.6,6.9,19,33,57.6,27.2,51,130,39.2
Monte Morris,DEN,26,47,45,42.4,89,162,54.9,55.2,40.8,88,156,56.4,1.6,1,6,16.7
Desmond Bane,MEM,23,68,63,32.5,75,162,46.3,47.5,28.7,71,143,49.7,3.8,4,19,21.1
Daniel Theis,CHI,29,65,52,34.5,107,161,66.5,66.8,33.0,106,154,68.8,1.5,1,7,14.3
Daniel Gafford,WAS,22,54,49,71.9,107,161,66.5,66.5,71.9,107,161,66.5,0.0,0,0,-
Terence Davis,SAC,24,61,49,34.4,73,157,46.5,51.0,25.7,59,117,50.4,8.8,14,40,35.0
Robert Covington,POR,30,70,57,30.8,60,157,38.2,42.7,19.8,46,101,45.5,11.0,14,56,25.0
Khem Birch,TOR,28,67,59,41.1,81,156,51.9,51.9,41.1,81,156,51.9,0.0,0,0,-
Jordan Poole,GSW,22,51,44,32.7,85,155,54.8,58.4,26.4,74,125,59.2,6.3,11,30,36.7
Danny Green,PHI,34,69,60,28.4,54,155,34.8,43.2,13.4,28,73,38.4,15.0,26,82,31.7
Cameron Payne,PHX,26,60,53,38.8,77,153,50.3,50.7,37.1,76,146,52.1,1.8,1,7,14.3
Robert Williams III,BOS,23,52,48,58.9,110,152,72.4,72.4,58.5,110,151,72.8,0.4,0,1,0.0
Draymond Green,GSW,31,63,57,40.0,83,152,54.6,54.6,39.5,83,150,55.3,0.5,0,2,0.0
Nickeil Alexander-Walker,NOP,22,46,41,33.3,65,152,42.8,44.4,29.2,60,133,45.1,4.2,5,19,26.3
James Johnson,NOP,34,51,45,46.2,81,151,53.6,54.0,44.3,80,145,55.2,1.8,1,6,16.7
Ricky Rubio,MIN,30,68,59,30.3,66,151,43.7,44.0,28.1,65,140,46.4,2.2,1,11,9.1
Terance Mann,LAC,24,67,52,43.6,83,150,55.3,55.3,42.4,83,146,56.8,1.2,0,4,0.0
Lonzo Ball,NOP,23,55,51,21.3,62,149,41.6,46.3,15.2,48,106,45.3,6.2,14,43,32.6
Kira Lewis Jr.,NOP,20,54,46,43.9,67,148,45.3,45.3,43.3,67,146,45.9,0.6,0,2,0.0
Blake Griffin,BKN,32,46,43,36.2,76,147,51.7,52.0,31.8,75,129,58.1,4.4,1,18,5.6
De'Anthony Melton,MEM,23,52,49,37.4,67,147,45.6,49.7,30.8,55,121,45.5,6.6,12,26,46.2
Justin Holiday,IND,32,72,59,23.4,60,146,41.1,48.3,13.8,39,86,45.3,9.6,21,60,35.0
Serge Ibaka,LAC,31,41,41,40.7,85,145,58.6,59.0,38.5,84,137,61.3,2.2,1,8,12.5
Kenyon Martin Jr.,HOU,20,45,39,45.6,79,145,54.5,54.5,45.3,79,144,54.9,0.3,0,1,0.0
R.J. Hampton,ORL,20,51,42,46.3,65,145,44.8,44.8,46.3,65,145,44.8,0.0,0,0,-
Malik Monk,CHA,23,42,37,35.8,60,143,42.0,43.4,30.1,56,120,46.7,5.8,4,23,17.4
Jarred Vanderbilt,MIN,22,64,52,60.2,85,142,59.9,59.9,59.3,85,140,60.7,0.8,0,2,0.0
Moses Brown,BOS,21,43,41,54.2,80,141,56.7,56.7,54.2,80,141,56.7,0.0,0,0,-
Dario Saric,PHX,27,50,46,41.2,77,141,54.6,55.0,40.4,76,138,55.1,0.9,1,3,33.3
Joe Ingles,UTA,33,67,58,24.9,76,140,54.3,58.2,19.0,65,107,60.7,5.9,11,33,33.3
Xavier Tillman,MEM,22,59,48,45.8,84,137,61.3,61.3,45.5,84,136,61.8,0.3,0,1,0.0
Tomas Satoransky,CHI,29,58,51,41.9,80,137,58.4,59.1,40.4,78,132,59.1,1.5,2,5,40.0
JaMychal Green,DEN,31,58,50,36.8,62,137,45.3,48.5,27.7,53,103,51.5,9.1,9,34,26.5
Eric Paschall,GSW,24,40,39,46.2,72,135,53.3,53.3,45.5,72,133,54.1,0.7,0,2,0.0
Kevin Porter Jr.,HOU,21,26,26,36.8,65,135,48.1,50.0,31.3,60,115,52.2,5.4,5,20,25.0
Edmond Sumner,IND,25,53,47,47.0,72,133,54.1,54.5,45.9,71,130,54.6,1.1,1,3,33.3
Derrick White,SAS,26,36,35,29.4,55,133,41.4,42.1,25.7,53,116,45.7,3.8,2,17,11.8
Saben Lee,DET,22,48,40,62.4,59,131,45.0,45.0,61.4,59,129,45.7,1.0,0,2,0.0
Anfernee Simons,POR,22,64,53,32.7,45,131,34.4,40.8,18.2,28,73,38.4,14.5,17,58,29.3
Jeff Teague,MIL,33,55,45,45.9,57,130,43.8,44.2,45.6,56,129,43.4,0.4,1,1,100
Hassan Whiteside,SAC,32,36,32,57.6,72,129,55.8,55.8,57.6,72,129,55.8,0.0,0,0,-
Ben McLemore,LAL,28,53,42,36.2,45,129,34.9,44.6,13.5,20,48,41.7,22.8,25,81,30.9
Precious Achiuwa,MIA,21,61,49,56.1,68,128,53.1,53.1,56.1,68,128,53.1,0.0,0,0,-
Drew Eubanks,SAS,24,54,49,62.0,71,127,55.9,55.9,62.0,71,127,55.9,0.0,0,0,-
Aron Baynes,TOR,34,53,45,41.9,67,127,52.8,53.1,40.9,66,124,53.2,1.0,1,3,33.3
Brad Wanamaker,CHA,31,61,53,43.1,57,127,44.9,44.9,41.7,57,123,46.3,1.4,0,4,0.0
Markieff Morris,LAL,31,61,48,33.5,61,126,48.4,48.8,29.8,60,112,53.6,3.7,1,14,7.1
Reggie Bullock,NYK,30,65,54,22.6,52,126,41.3,46.8,14.5,38,81,46.9,8.1,14,45,31.1
Jalen McDaniels,CHA,23,47,41,44.2,63,125,50.4,50.4,42.4,63,120,52.5,1.8,0,5,0.0
Michael Carter-Williams,ORL,29,31,30,45.9,54,124,43.5,43.5,45.2,54,122,44.3,0.7,0,2,0.0
Trey Burke,DAL,28,62,48,35.1,47,124,37.9,39.5,30.3,43,107,40.2,4.8,4,17,23.5
Malachi Flynn,TOR,23,47,33,36.1,53,123,43.1,47.2,27.0,43,92,46.7,9.1,10,31,32.3
PJ Dozier,DEN,24,50,46,34.8,60,122,49.2,50.4,31.9,57,112,50.9,2.8,3,10,30.0
Kent Bazemore,GSW,31,67,54,31.1,60,121,49.6,50.4,28.5,58,111,52.3,2.6,2,10,20.0
Kentavious Caldwell-Pope,LAL,28,67,54,24.3,49,120,40.8,44.2,18.4,41,91,45.1,5.9,8,29,27.6
Danilo Gallinari,ATL,32,51,49,25.2,53,119,44.5,48.3,20.3,44,96,45.8,4.9,9,23,39.1
Gary Harris,ORL,26,39,37,35.3,45,119,37.8,38.7,31.8,43,107,40.2,3.6,2,12,16.7
Nerlens Noel,NYK,27,64,51,52.2,73,117,62.4,62.4,51.8,73,116,62.9,0.4,0,1,0.0
Dwight Powell,DAL,29,58,46,60.1,71,116,61.2,61.2,60.1,71,116,61.2,0.0,0,0,-
De'Andre Hunter,ATL,23,23,23,46.4,61,116,52.6,53.4,42.4,59,106,55.7,4.0,2,10,20.0
Bryn Forbes,MIL,27,70,59,21.9,51,116,44.0,51.7,14.2,33,75,44.0,7.8,18,41,43.9
Kevon Looney,GSW,25,61,47,58.7,74,115,64.3,64.3,58.2,74,114,64.9,0.5,0,1,0.0
Mo Bamba,ORL,23,46,40,38.2,64,115,55.7,56.1,36.9,63,111,56.8,1.3,1,4,25.0
Aleksej Pokusevski,OKC,19,45,38,28.8,42,115,36.5,38.3,25.8,38,103,36.9,3.0,4,12,33.3
Taurean Prince,CLE,27,41,38,35.5,46,114,40.4,42.5,30.2,41,97,42.3,5.3,5,17,29.4
Al Horford,OKC,35,28,27,31.4,63,113,55.8,55.8,31.1,63,112,56.3,0.3,0,1,0.0
Derrick Favors,UTA,29,68,57,46.1,74,112,66.1,66.1,46.1,74,112,66.1,0.0,0,0,-
Mitchell Robinson,NYK,23,31,29,67.5,73,112,65.2,65.2,67.5,73,112,65.2,0.0,0,0,-
Garrett Temple,CHI,35,56,44,29.4,57,112,50.9,51.3,26.8,56,102,54.9,2.6,1,10,10.0
Onyeka Okongwu,ATL,20,50,41,74.5,74,111,66.7,66.7,73.2,74,109,67.9,1.3,0,2,0.0
Tony Bradley,OKC,23,42,38,56.7,80,110,72.7,72.7,56.7,80,110,72.7,0.0,0,0,-
Isaiah Hartenstein,CLE,23,46,39,64.3,64,110,58.2,58.2,64.3,64,110,58.2,0.0,0,0,-
Sekou Doumbouya,DET,20,56,42,39.3,52,110,47.3,47.3,36.8,52,103,50.5,2.5,0,7,0.0
Rodney Hood,TOR,28,55,43,41.9,42,109,38.5,40.8,35.8,37,93,39.8,6.2,5,16,31.3
Denzel Valentine,CHI,27,62,41,26.2,40,109,36.7,37.2,24.0,39,100,39.0,2.2,1,9,11.1
Frank Kaminsky,PHX,28,47,37,42.7,51,108,47.2,47.7,41.9,50,106,47.2,0.8,1,2,50.0
Jaylen Nowell,MIN,21,42,37,32.2,47,108,43.5,44.0,31.3,46,105,43.8,0.9,1,3,33.3
DeAndre' Bembry,TOR,26,51,39,46.9,68,107,63.6,63.6,46.1,68,105,64.8,0.9,0,2,0.0
Eric Gordon,HOU,32,27,26,30.0,62,107,57.9,58.4,28.3,61,101,60.4,1.7,1,6,16.7
Jordan McLaughlin,MIN,25,51,44,44.2,50,107,46.7,46.7,43.0,50,104,48.1,1.2,0,3,0.0
JJ Redick,DAL,37,44,39,40.1,34,107,31.8,38.8,19.1,19,51,37.3,21.0,15,56,26.8
Luke Kennard,LAC,25,63,42,26.0,54,106,50.9,54.7,21.9,46,89,51.7,4.2,8,17,47.1
Dorian Finney-Smith,DAL,28,60,52,22.6,63,105,60.0,60.5,21.9,62,102,60.8,0.6,1,3,33.3
David Nwaba,HOU,28,30,27,50.5,59,105,56.2,56.2,50.0,59,104,56.7,0.5,0,1,0.0
Landry Shamet,BKN,24,61,49,23.0,40,105,38.1,41.9,15.8,32,72,44.4,7.2,8,33,24.2
Payton Pritchard,BOS,23,66,45,24.9,51,104,49.0,51.0,21.3,47,89,52.8,3.6,4,15,26.7
Ty Jerome,OKC,23,33,32,36.2,48,104,46.2,49.0,31.0,42,89,47.2,5.2,6,15,40.0
Furkan Korkmaz,PHI,23,55,51,24.5,46,104,44.2,47.6,18.6,39,79,49.4,5.9,7,25,28.0
Jeremy Lamb,IND,29,36,35,37.7,44,104,42.3,44.7,33.0,39,91,42.9,4.7,5,13,38.5
Ish Smith,WAS,32,44,39,35.0,43,104,41.3,42.3,32.3,41,96,42.7,2.7,2,8,25.0
Frank Jackson,DET,23,40,35,35.2,50,103,48.5,50.5,29.7,46,87,52.9,5.5,4,16,25.0
DeMarcus Cousins,LAC,30,41,39,35.3,46,103,44.7,45.1,32.5,45,95,47.4,2.7,1,8,12.5
Juancho Hernangomez,MIN,25,52,43,34.2,58,102,56.9,58.8,29.9,54,89,60.7,4.4,4,13,30.8
Jaden McDaniels,MIN,20,63,41,27.8,51,102,50.0,50.0,27.8,51,102,50.0,0.0,0,0,-
Josh Hart,NOP,26,47,40,29.7,50,102,49.0,50.0,25.6,48,88,54.5,4.1,2,14,14.3
Devin Vassell,SAS,20,62,45,33.3,50,101,49.5,53.5,27.4,42,83,50.6,5.9,8,18,44.4
LaMarcus Aldridge,BKN,35,26,26,33.4,40,99,40.4,41.4,30.4,38,90,42.2,3.0,2,9,22.2
Nic Claxton,BKN,22,32,30,66.9,63,97,64.9,64.9,66.9,63,97,64.9,0.0,0,0,-
Derrick Jones Jr.,POR,24,58,45,31.9,58,97,59.8,59.8,31.3,58,95,61.1,0.7,0,2,0.0
Chuma Okeke,ORL,22,45,34,29.9,46,97,47.4,48.5,26.2,44,85,51.8,3.7,2,12,16.7
Sterling Brown,HOU,26,51,44,29.2,40,96,41.7,42.2,23.1,39,76,51.3,6.1,1,20,5.0
Willie Cauley-Stein,DAL,27,53,39,52.2,64,95,67.4,67.4,52.2,64,95,67.4,0.0,0,0,-
Larry Nance Jr.,CLE,28,35,32,34.9,51,95,53.7,53.7,34.2,51,93,54.8,0.7,0,2,0.0
Moritz Wagner,ORL,24,45,35,41.5,45,95,47.4,47.9,39.7,44,91,48.4,1.7,1,4,25.0
Wayne Ellington,DET,33,46,39,28.8,39,95,41.1,55.3,8.2,12,27,44.4,20.6,27,68,39.7
Justise Winslow,MEM,25,26,25,44.3,42,93,45.2,45.2,44.3,42,93,45.2,0.0,0,0,-
Pat Connaughton,MIL,28,69,49,23.8,44,92,47.8,50.5,18.1,39,70,55.7,5.7,5,22,22.7
Grayson Allen,MEM,25,50,38,22.2,39,92,42.4,44.0,19.8,36,82,43.9,2.4,3,10,30.0
Taj Gibson,NYK,36,45,40,57.6,57,91,62.6,62.6,57.0,57,90,63.3,0.6,0,1,0.0
Cameron Johnson,PHX,25,60,51,19.0,56,91,61.5,63.7,16.3,52,78,66.7,2.7,4,13,30.8
D.J. Augustin,HOU,33,57,48,26.5,33,91,36.3,40.7,19.8,25,68,36.8,6.7,8,23,34.8
Josh Okogie,MIN,22,59,50,34.6,41,88,46.6,46.6,33.5,41,85,48.2,1.2,0,3,0.0
Jae Crowder,PHX,30,60,44,18.0,31,88,35.2,42.6,9.4,18,46,39.1,8.6,13,42,31.0
James Ennis III,ORL,30,41,36,35.8,43,87,49.4,49.4,34.6,43,84,51.2,1.2,0,3,0.0
Alex Caruso,LAL,27,58,44,29.1,38,87,43.7,43.7,28.1,38,84,45.2,1.0,0,3,0.0
Deni Avdija,WAS,20,54,39,27.6,47,86,54.7,54.7,26.9,47,84,56.0,0.6,0,2,0.0
Nicolas Batum,LAC,32,67,49,20.9,46,86,53.5,55.8,17.0,42,70,60.0,3.9,4,16,25.0
Cam Reddish,ATL,21,26,26,32.3,33,85,38.8,40.0,30.4,31,80,38.8,1.9,2,5,40.0
Thanasis Antetokounmpo,MIL,28,57,32,60.6,49,83,59.0,59.0,59.9,49,82,59.8,0.7,0,1,0.0
Royce O'Neale,UTA,28,71,51,20.8,48,82,58.5,59.8,19.5,46,77,59.7,1.3,2,5,40.0
Damyean Dotson,CLE,27,46,35,28.2,41,82,50.0,50.0,23.7,41,69,59.4,4.5,0,13,0.0
Rajon Rondo,LAC,35,45,36,37.7,42,81,51.9,51.9,37.7,42,81,51.9,0.0,0,0,-
Killian Hayes,DET,19,26,24,40.9,32,81,39.5,40.1,36.9,31,73,42.5,4.0,1,8,12.5
Garrison Mathews,WAS,24,64,39,34.2,32,81,39.5,53.7,10.1,9,24,37.5,24.1,23,57,40.4
Caleb Martin,CHA,25,53,41,31.3,38,80,47.5,48.8,29.3,36,75,48.0,2.0,2,5,40.0
Naji Marshall,NOP,23,32,25,38.5,36,80,45.0,46.3,36.1,34,75,45.3,2.4,2,5,40.0
Chasson Randle,ORL,28,41,32,33.8,31,80,38.8,42.5,26.2,25,62,40.3,7.6,6,18,33.3
Justin Jackson,MIL,26,34,30,35.7,41,79,51.9,52.5,34.8,40,77,51.9,0.9,1,2,50.0
Jarrett Culver,MIN,22,34,26,47.0,36,79,45.6,45.6,43.5,36,73,49.3,3.6,0,6,0.0
Danuel House Jr.,HOU,28,36,32,29.0,36,79,45.6,47.5,24.3,33,66,50.0,4.8,3,13,23.1
Georges Niang,UTA,28,72,44,19.6,35,79,44.3,44.9,17.6,34,71,47.9,2.0,1,8,12.5
Boban Marjanovic,DAL,32,33,24,63.9,40,78,51.3,51.3,63.9,40,78,51.3,0.0,0,0,-
Timothe Luwawu-Cabarrot,BKN,26,58,41,21.9,33,78,42.3,43.6,17.7,31,63,49.2,4.2,2,15,13.3
Brandon Goodwin,ATL,25,47,34,35.1,31,78,39.7,40.4,32.4,30,72,41.7,2.7,1,6,16.7
Goga Bitadze,IND,21,45,34,39.7,37,77,48.1,48.1,38.7,37,75,49.3,1.0,0,2,0.0
Kevin Love,CLE,32,25,23,30.6,31,77,40.3,42.2,22.6,28,57,49.1,7.9,3,20,15.0
Juan Toscano-Anderson,GSW,28,53,31,35.9,51,75,68.0,68.7,34.9,50,73,68.5,1.0,1,2,50.0
Cody Martin,CHA,25,52,35,39.9,39,75,52.0,52.0,39.4,39,74,52.7,0.5,0,1,0.0
Trevor Ariza,MIA,36,30,29,30.7,31,74,41.9,45.3,24.5,26,59,44.1,6.2,5,15,33.3
Nemanja Bjelica,MIA,33,37,27,37.2,37,73,50.7,50.7,35.7,37,70,52.9,1.5,0,3,0.0
Grant Williams,BOS,22,63,43,29.4,36,73,49.3,49.3,28.2,36,70,51.4,1.2,0,3,0.0
Gabe Vincent,MIA,25,50,33,31.3,33,73,45.2,45.9,24.9,32,58,55.2,6.4,1,15,6.7
Chimezie Metu,SAC,24,36,29,40.2,40,72,55.6,56.9,38.5,38,69,55.1,1.7,2,3,66.7
George Hill,PHI,35,30,26,36.5,40,72,55.6,56.3,34.5,39,68,57.4,2.0,1,4,25.0
Tyler Cook,DET,23,32,22,70.4,50,69,72.5,72.5,70.4,50,69,72.5,0.0,0,0,-
Obi Toppin,NYK,23,62,39,33.3,38,69,55.1,55.1,32.9,38,68,55.9,0.5,0,1,0.0
Austin Rivers,DEN,28,36,27,27.8,31,68,45.6,47.1,24.9,29,61,47.5,2.9,2,7,28.6
Otto Porter Jr.,ORL,28,28,26,29.5,32,67,47.8,48.5,26.0,31,59,52.5,3.5,1,8,12.5
JaKarr Sampson,IND,28,29,25,58.4,36,66,54.5,54.5,58.4,36,66,54.5,0.0,0,0,-
Nassir Little,POR,21,48,34,39.5,35,66,53.0,53.0,34.7,35,58,60.3,4.8,0,8,0.0
Torrey Craig,PHX,30,50,31,29.1,34,66,51.5,53.8,26.0,31,59,52.5,3.1,3,7,42.9
Max Strus,MIA,25,39,25,35.5,30,66,45.5,52.3,12.9,21,24,87.5,22.6,9,42,21.4
Damian Jones,SAC,26,39,29,62.1,49,64,76.6,76.6,62.1,49,64,76.6,0.0,0,0,-
Dean Wade,CLE,24,63,37,20.6,35,64,54.7,55.5,19.0,34,59,57.6,1.6,1,5,20.0
Lamar Stevens,CLE,23,40,29,47.1,31,64,48.4,48.4,44.1,31,60,51.7,2.9,0,4,0.0
Facundo Campazzo,DEN,30,65,40,20.0,33,63,52.4,54.0,19.4,31,61,50.8,0.6,2,2,100
Yuta Watanabe,TOR,26,50,34,34.4,33,62,53.2,54.0,33.9,32,61,52.5,0.6,1,1,100
Jake Layman,MIN,27,45,32,33.2,37,61,60.7,61.5,32.6,36,60,60.0,0.5,1,1,100
Jahlil Okafor,DET,25,27,24,60.4,36,61,59.0,59.0,58.4,36,59,61.0,2.0,0,2,0.0
Andre Iguodala,MIA,37,63,39,24.5,22,61,36.1,39.3,17.3,18,43,41.9,7.2,4,18,22.2
Stanley Johnson,TOR,25,61,30,26.3,22,61,36.1,36.1,22.4,22,52,42.3,3.9,0,9,0.0
Damion Lee,GSW,28,57,38,22.0,35,60,58.3,63.3,16.8,29,46,63.0,5.1,6,14,42.9
John Konchar,MEM,25,43,30,42.8,34,59,57.6,59.3,40.6,32,56,57.1,2.2,2,3,66.7
Matisse Thybulle,PHI,24,65,37,24.3,32,59,54.2,55.9,21.8,30,53,56.6,2.5,2,6,33.3
Jaylen Hoard,OKC,22,19,16,67.4,31,58,53.4,53.4,64.0,31,55,56.4,3.5,0,3,0.0
Mychal Mulder,GSW,27,60,34,22.0,27,58,46.6,54.3,12.5,18,33,54.5,9.5,9,25,36.0
Chandler Hutchison,WAS,25,25,21,56.3,20,58,34.5,34.5,54.4,20,56,35.7,1.9,0,2,0.0
Solomon Hill,ATL,30,71,33,19.2,24,57,42.1,43.0,17.8,23,53,43.4,1.3,1,4,25.0
Freddie Gillespie,TOR,24,20,19,65.5,31,55,56.4,56.4,65.5,31,55,56.4,0.0,0,0,-
E'Twaun Moore,PHX,32,27,21,45.5,24,55,43.6,45.5,41.3,22,50,44.0,4.1,2,5,40.0
Maurice Harkless,SAC,28,37,21,32.7,30,54,55.6,55.6,31.5,30,52,57.7,1.2,0,2,0.0
Aaron Nesmith,BOS,21,46,29,30.3,26,54,48.1,50.9,27.0,23,48,47.9,3.4,3,6,50.0
Armoni Brooks,HOU,23,20,18,27.6,23,53,43.4,52.8,10.9,13,21,61.9,16.7,10,32,31.3
Paul Reed,PHI,22,26,18,62.8,29,49,59.2,59.2,62.8,29,49,59.2,0.0,0,0,-
Gorgui Dieng,SAS,31,38,24,30.2,27,49,55.1,56.1,28.4,26,46,56.5,1.9,1,3,33.3
Abdel Nader,PHX,27,24,22,43.4,26,49,53.1,53.1,43.4,26,49,53.1,0.0,0,0,-
Javonte Green,CHI,27,41,27,48.0,23,49,46.9,46.9,48.0,23,49,46.9,0.0,0,0,-
Justin James,SAC,24,36,19,43.2,23,48,47.9,51.0,37.8,20,42,47.6,5.4,3,6,50.0
Kelan Martin,IND,25,35,21,34.8,20,48,41.7,42.7,33.3,19,46,41.3,1.4,1,2,50.0
Mike Muscala,OKC,29,35,27,17.6,25,47,53.2,54.3,15.0,24,40,60.0,2.6,1,7,14.3
Troy Brown Jr.,CHI,21,34,27,32.6,23,47,48.9,50.0,28.5,22,41,53.7,4.2,1,6,16.7
Markelle Fultz,ORL,23,8,8,44.2,28,46,60.9,60.9,44.2,28,46,60.9,0.0,0,0,-
Tre Jones,SAS,21,37,25,59.0,22,46,47.8,48.9,57.7,21,45,46.7,1.3,1,1,100
Patrick Beverley,LAC,32,37,26,21.3,19,46,41.3,44.6,18.1,16,39,41.0,3.2,3,7,42.9
Jevon Carter,PHX,25,60,23,20.4,23,45,51.1,56.7,14.5,18,32,56.3,5.9,5,13,38.5
Jaren Jackson Jr.,MEM,21,11,11,36.0,21,45,46.7,46.7,34.4,21,43,48.8,1.6,0,2,0.0
Dennis Smith Jr.,DET,23,23,19,31.0,20,45,44.4,45.6,28.3,19,41,46.3,2.8,1,4,25.0
Oshae Brissett,IND,23,21,18,29.8,19,45,42.2,42.2,29.8,19,45,42.2,0.0,0,0,-
Nathan Knight,ATL,23,33,21,43.4,21,43,48.8,48.8,42.4,21,42,50.0,1.0,0,1,0.0
Skylar Mays,ATL,23,33,20,42.9,20,42,47.6,48.8,38.8,19,38,50.0,4.1,1,4,25.0
Semi Ojeleye,BOS,26,56,24,19.0,19,42,45.2,45.2,17.2,19,38,50.0,1.8,0,4,0.0
Langston Galloway,PHX,29,40,24,28.6,18,42,42.9,44.0,21.8,17,32,53.1,6.8,1,10,10.0
Kyle Guy,SAC,23,31,18,47.7,16,42,38.1,42.9,31.8,12,28,42.9,15.9,4,14,28.6
Anthony Lamb,HOU,23,24,17,35.6,13,42,31.0,33.3,24.6,11,29,37.9,11.0,2,13,15.4
Dylan Windler,CLE,24,31,20,31.8,22,41,53.7,54.9,27.1,21,35,60.0,4.7,1,6,16.7
Reggie Perry,BKN,21,26,18,53.2,22,41,53.7,53.7,53.2,22,41,53.7,0.0,0,0,-
Jordan Nwora,MIL,22,30,14,30.4,17,41,41.5,41.5,28.9,17,39,43.6,1.5,0,2,0.0
Harry Giles III,POR,23,38,22,42.3,17,41,41.5,41.5,42.3,17,41,41.5,0.0,0,0,-
Tony Snell,ATL,29,47,23,24.1,16,41,39.0,41.5,21.2,14,36,38.9,2.9,2,5,40.0
Carsen Edwards,BOS,23,31,19,36.0,19,40,47.5,51.3,24.3,16,27,59.3,11.7,3,13,23.1
D.J. Wilson,HOU,25,35,22,23.8,17,40,42.5,42.5,23.2,17,39,43.6,0.6,0,1,0.0
Josh Hall,OKC,20,21,16,43.0,16,40,40.0,40.0,40.9,16,38,42.1,2.2,0,2,0.0
Alize Johnson,BKN,25,18,14,57.4,23,39,59.0,59.0,55.9,23,38,60.5,1.5,0,1,0.0
Al-Farouq Aminu,CHI,30,23,17,39.4,18,39,46.2,46.2,38.4,18,38,47.4,1.0,0,1,0.0
P.J. Tucker,MIL,36,52,26,22.5,18,39,46.2,48.7,19.1,16,33,48.5,3.5,2,6,33.3
Nicolo Melli,DAL,30,45,22,27.7,11,39,28.2,29.5,23.4,10,33,30.3,4.3,1,6,16.7
Thomas Bryant,WAS,23,10,9,41.8,30,38,78.9,78.9,41.8,30,38,78.9,0.0,0,0,-
Josh Green,DAL,20,39,23,40.9,20,38,52.6,52.6,40.9,20,38,52.6,0.0,0,0,-
Avery Bradley,HOU,30,27,20,22.2,20,38,52.6,52.6,21.6,20,37,54.1,0.6,0,1,0.0
Markus Howard,DEN,22,37,16,35.8,12,38,31.6,34.2,22.6,10,24,41.7,13.2,2,14,14.3
Mike James,BKN,30,13,11,41.3,11,38,28.9,31.6,34.8,9,32,28.1,6.5,2,6,33.3
Luka Samanic,SAS,21,33,17,35.2,24,37,64.9,64.9,35.2,24,37,64.9,0.0,0,0,-
Shaquille Harrison,DEN,27,34,20,49.3,14,37,37.8,37.8,49.3,14,37,37.8,0.0,0,0,-
Matt Thomas,UTA,26,45,23,29.1,11,37,29.7,36.5,16.5,6,21,28.6,12.6,5,16,31.3
DaQuan Jeffries,SAS,23,31,20,30.0,18,36,50.0,50.0,26.7,18,32,56.3,3.3,0,4,0.0
Nico Mannion,GSW,20,30,13,32.4,15,36,41.7,45.8,29.7,12,33,36.4,2.7,3,3,100
Mike Scott,PHI,32,51,23,17.1,15,36,41.7,43.1,13.7,14,29,48.3,3.3,1,7,14.3
Trey Lyles,SAS,25,23,15,38.9,23,35,65.7,67.1,35.6,22,32,68.8,3.3,1,3,33.3
Maxi Kleber,DAL,29,50,25,12.7,15,35,42.9,42.9,12.7,15,35,42.9,0.0,0,0,-
Ignas Brazdeikis,ORL,22,13,10,41.0,17,34,50.0,50.0,41.0,17,34,50.0,0.0,0,0,-
Trent Forrest,UTA,23,30,17,46.5,23,33,69.7,69.7,46.5,23,33,69.7,0.0,0,0,-
Wes Iwundu,NOP,26,41,20,32.4,14,33,42.4,42.4,31.4,14,32,43.8,1.0,0,1,0.0
Tremont Waters,BOS,23,26,16,39.3,12,33,36.4,37.9,36.9,11,31,35.5,2.4,1,2,50.0
Rodney McGruder,DET,29,16,12,45.7,17,32,53.1,53.1,45.7,17,32,53.1,0.0,0,0,-
Glenn Robinson III,SAC,27,23,15,32.3,16,32,50.0,51.6,31.3,15,31,48.4,1.0,1,1,100
Amir Coffey,LAC,24,44,21,31.1,15,32,46.9,46.9,30.1,15,31,48.4,1.0,0,1,0.0
Ed Davis,MIN,32,23,15,72.7,14,32,43.8,43.8,72.7,14,32,43.8,0.0,0,0,-
Bruno Fernando,ATL,22,33,15,72.7,12,32,37.5,37.5,72.7,12,32,37.5,0.0,0,0,-
Patrick Patterson,LAC,32,38,18,19.5,17,31,54.8,54.8,17.6,17,28,60.7,1.9,0,3,0.0
Marc Gasol,LAL,36,52,23,16.1,16,31,51.6,51.6,16.1,16,31,51.6,0.0,0,0,-
Dewayne Dedmon,MIA,31,16,14,46.2,24,30,80.0,80.0,46.2,24,30,80.0,0.0,0,0,-
Alfonzo McKinnie,LAL,28,39,18,32.3,21,30,70.0,71.7,31.2,20,29,69.0,1.1,1,1,100
Vlatko Cancar,DEN,24,41,19,41.1,15,30,50.0,51.7,35.6,14,26,53.8,5.5,1,4,25.0
Tyler Johnson,BKN,29,39,22,16.4,14,30,46.7,51.7,13.1,11,24,45.8,3.3,3,6,50.0
Bol Bol,DEN,21,32,18,51.7,12,30,40.0,43.3,39.7,10,23,43.5,12.1,2,7,28.6
Wesley Matthews,LAL,34,58,23,12.0,12,30,40.0,40.0,10.8,12,27,44.4,1.2,0,3,0.0
KZ Okpala,MIA,22,37,16,30.2,14,29,48.3,48.3,28.1,14,27,51.9,2.1,0,2,0.0
Kevin Knox II,NYK,21,42,15,20.4,9,29,31.0,32.8,19.0,8,27,29.6,1.4,1,2,50.0
Luke Kornet,BOS,25,31,16,27.7,18,28,64.3,64.3,25.7,18,26,69.2,2.0,0,2,0.0
Keita Bates-Diop,SAS,25,30,11,42.4,16,28,57.1,57.1,40.9,16,27,59.3,1.5,0,1,0.0
Ryan Arcidiacono,CHI,27,44,19,23.9,14,28,50.0,51.8,22.2,13,26,50.0,1.7,1,2,50.0
T.J. Warren,IND,27,4,4,52.9,15,27,55.6,55.6,52.9,15,27,55.6,0.0,0,0,-
Mason Jones,PHI,22,32,18,22.1,12,27,44.4,44.4,22.1,12,27,44.4,0.0,0,0,-
Jabari Parker,BOS,26,13,10,47.3,16,26,61.5,61.5,47.3,16,26,61.5,0.0,0,0,-
Zeke Nnaji,DEN,20,42,20,25.0,14,26,53.8,55.8,21.2,13,22,59.1,3.8,1,4,25.0
Gabriel Deck,OKC,26,10,9,40.0,12,26,46.2,46.2,36.9,12,24,50.0,3.1,0,2,0.0
Quinn Cook,CLE,28,23,13,38.2,10,26,38.5,40.4,33.8,9,23,39.1,4.4,1,3,33.3
Anthony Gill,WAS,28,26,12,41.7,17,25,68.0,68.0,41.7,17,25,68.0,0.0,0,0,-
Mfiondu Kabengele,CLE,23,39,15,28.1,13,25,52.0,52.0,27.0,13,24,54.2,1.1,0,1,0.0
Romeo Langford,BOS,21,18,13,42.4,9,25,36.0,36.0,42.4,9,25,36.0,0.0,0,0,-
Justin Patton,HOU,24,13,11,34.3,14,24,58.3,58.3,32.9,14,23,60.9,1.4,0,1,0.0
Isaac Bonga,WAS,21,40,18,29.6,10,24,41.7,41.7,29.6,10,24,41.7,0.0,0,0,-
Jalen Harris,TOR,22,13,8,33.3,10,24,41.7,43.8,29.2,9,21,42.9,4.2,1,3,33.3
Khyri Thomas,HOU,25,5,4,34.8,14,23,60.9,60.9,31.8,14,21,66.7,3.0,0,2,0.0
Devontae Cacok,LAL,24,20,12,79.3,14,23,60.9,60.9,79.3,14,23,60.9,0.0,0,0,-
Chris Chiozza,BKN,25,22,12,25.8,10,23,43.5,43.5,24.7,10,22,45.5,1.1,0,1,0.0
Jerome Robinson,WAS,24,17,13,24.2,6,23,26.1,26.1,23.2,6,22,27.3,1.1,0,1,0.0
Daniel Oturu,LAC,21,30,14,48.9,9,22,40.9,40.9,46.7,9,21,42.9,2.2,0,1,0.0
Donta Hall,ORL,23,13,8,60.0,15,21,71.4,71.4,60.0,15,21,71.4,0.0,0,0,-
Paul Watson,TOR,26,27,12,25.6,12,21,57.1,73.8,13.4,5,11,45.5,12.2,7,10,70.0
Jalen Smith,PHX,21,27,12,42.0,11,21,52.4,52.4,40.0,11,20,55.0,2.0,0,1,0.0
Brodric Thomas,CLE,24,32,13,19.4,9,21,42.9,42.9,15.7,9,17,52.9,3.7,0,4,0.0
Quinndary Weatherspoon,SAS,24,20,8,57.1,10,20,50.0,50.0,57.1,10,20,50.0,0.0,0,0,-
Tacko Fall,BOS,25,19,13,65.5,13,19,68.4,68.4,65.5,13,19,68.4,0.0,0,0,-
Sam Merrill,MIL,25,30,13,26.4,11,19,57.9,63.2,23.6,9,17,52.9,2.8,2,2,100
Jarrell Brantley,UTA,25,28,11,36.5,10,19,52.6,55.3,32.7,9,17,52.9,3.8,1,2,50.0
Mamadi Diakite,MIL,24,14,7,47.5,8,19,42.1,42.1,45.0,8,18,44.4,2.5,0,1,0.0
Wenyen Gabriel,NOP,24,21,13,31.7,7,19,36.8,36.8,31.7,7,19,36.8,0.0,0,0,-
Killian Tillie,MEM,23,18,11,33.3,7,19,36.8,39.5,31.6,6,18,33.3,1.8,1,1,100
Yogi Ferrell,LAC,28,10,6,35.8,7,19,36.8,39.5,26.4,6,14,42.9,9.4,1,5,20.0
Frank Ntilikina,NYK,22,33,12,22.8,4,18,22.2,25.0,17.7,3,14,21.4,5.1,1,4,25.0
Cassius Stanley,IND,21,24,16,41.9,3,18,16.7,16.7,41.9,3,18,16.7,0.0,0,0,-
Louis King,SAC,22,6,4,50.0,9,17,52.9,52.9,50.0,9,17,52.9,0.0,0,0,-
Gary Clark,PHI,26,39,14,12.9,7,17,41.2,44.1,10.6,6,14,42.9,2.3,1,3,33.3
CJ Elleby,POR,21,30,12,25.8,7,17,41.2,44.1,22.7,6,15,40.0,3.0,1,2,50.0
Matthew Dellavedova,CLE,30,13,12,30.4,6,17,35.3,35.3,30.4,6,17,35.3,0.0,0,0,-
Isaiah Joe,PHI,21,41,9,12.0,4,16,25.0,25.0,9.0,4,12,33.3,3.0,0,4,0.0
Sindarius Thornwell,ORL,26,21,10,33.3,3,15,20.0,20.0,31.1,3,14,21.4,2.2,0,1,0.0
Vernon Carey Jr.,CHA,20,19,8,38.9,9,14,64.3,64.3,38.9,9,14,64.3,0.0,0,0,-
Jordan Bell,GSW,26,6,6,63.6,4,14,28.6,28.6,63.6,4,14,28.6,0.0,0,0,-
Alen Smailagic,GSW,20,15,8,48.1,6,13,46.2,50.0,44.4,5,12,41.7,3.7,1,1,100
Dakota Mathias,PHI,25,8,4,27.1,4,13,30.8,30.8,20.8,4,10,40.0,6.3,0,3,0.0
Jahmi'us Ramsey,SAC,20,13,6,34.2,4,13,30.8,30.8,28.9,4,11,36.4,5.3,0,2,0.0
Jeremiah Martin,CLE,25,9,6,39.4,4,13,30.8,30.8,33.3,4,11,36.4,6.1,0,2,0.0
Dante Exum,HOU,25,6,4,46.2,4,12,33.3,33.3,42.3,4,11,36.4,3.8,0,1,0.0
Deividas Sirvydis,DET,21,20,6,30.0,4,12,33.3,37.5,25.0,3,10,30.0,5.0,1,2,50.0
Ersan Ilyasova,UTA,34,17,7,22.2,2,12,16.7,20.8,11.1,1,6,16.7,11.1,1,6,16.7
Jordan Bone,ORL,23,14,7,20.4,5,11,45.5,50.0,13.0,4,7,57.1,7.4,1,4,25.0
Frank Mason III,ORL,27,4,3,45.8,5,11,45.5,45.5,41.7,5,10,50.0,4.2,0,1,0.0
Tyler Bey,DAL,23,18,7,50.0,4,11,36.4,36.4,50.0,4,11,36.4,0.0,0,0,-
Miye Oni,UTA,23,54,11,11.1,4,11,36.4,36.4,9.1,4,9,44.4,2.0,0,2,0.0
Devin Cannady,ORL,25,8,6,39.3,3,11,27.3,27.3,32.1,3,9,33.3,7.1,0,2,0.0
Thon Maker,CLE,24,8,6,55.6,4,10,40.0,40.0,55.6,4,10,40.0,0.0,0,0,-
Jay Scrubb,LAC,20,4,4,40.0,4,10,40.0,40.0,40.0,4,10,40.0,0.0,0,0,-
Cassius Winston,WAS,23,22,8,30.3,3,10,30.0,30.0,24.2,3,8,37.5,6.1,0,2,0.0
Charlie Brown Jr.,OKC,24,9,6,25.6,3,10,30.0,35.0,20.5,2,8,25.0,5.1,1,2,50.0
Devon Dotson,CHI,21,11,5,42.9,6,9,66.7,66.7,42.9,6,9,66.7,0.0,0,0,-
Adam Mokoka,CHI,22,14,5,47.4,5,9,55.6,55.6,36.8,5,7,71.4,10.5,0,2,0.0
Robert Woodard II,SAC,21,13,3,47.4,4,9,44.4,44.4,42.1,4,8,50.0,5.3,0,1,0.0
Darius Miller,OKC,31,18,6,18.8,3,9,33.3,50.0,0.0,0,0,-,18.8,3,9,33.3
Keljin Blevins,POR,25,17,7,45.0,2,9,22.2,22.2,45.0,2,9,22.2,0.0,0,0,-
Nate Hinton,DAL,22,21,6,21.4,2,9,22.2,22.2,16.7,2,7,28.6,4.8,0,2,0.0
Sean McDermott,MEM,24,18,8,24.2,7,8,87.5,87.5,24.2,7,8,87.5,0.0,0,0,-
Rondae Hollis-Jefferson,POR,26,11,5,44.4,5,8,62.5,62.5,44.4,5,8,62.5,0.0,0,0,-
Bruno Caboclo,HOU,25,6,4,47.1,5,8,62.5,62.5,47.1,5,8,62.5,0.0,0,0,-
Rayjon Tucker,PHI,23,14,6,44.4,5,8,62.5,68.8,38.9,4,7,57.1,5.6,1,1,100
Marquese Chriss,GSW,23,2,2,57.1,4,8,50.0,50.0,57.1,4,8,50.0,0.0,0,0,-
Cristiano Felicio,CHI,28,18,5,53.8,5,7,71.4,71.4,53.8,5,7,71.4,0.0,0,0,-
Juwan Morgan,UTA,24,29,5,23.3,5,7,71.4,71.4,23.3,5,7,71.4,0.0,0,0,-
Cameron Oliver,HOU,24,4,4,21.2,4,7,57.1,57.1,21.2,4,7,57.1,0.0,0,0,-
Robert Franks,ORL,24,7,5,25.0,4,7,57.1,57.1,25.0,4,7,57.1,0.0,0,0,-
Spencer Dinwiddie,BKN,28,3,3,43.8,3,7,42.9,42.9,43.8,3,7,42.9,0.0,0,0,-
Kostas Antetokounmpo,LAL,23,15,5,70.0,2,7,28.6,28.6,70.0,2,7,28.6,0.0,0,0,-
Isaiah Thomas,NOP,32,3,2,25.9,1,7,14.3,14.3,22.2,1,6,16.7,3.7,0,1,0.0
Kris Dunn,ATL,27,4,3,58.3,1,7,14.3,14.3,58.3,1,7,14.3,0.0,0,0,-
Norvel Pelle,NYK,28,13,4,40.0,3,6,50.0,50.0,40.0,3,6,50.0,0.0,0,0,-
T.J. Leaf,POR,24,7,5,60.0,3,6,50.0,50.0,60.0,3,6,50.0,0.0,0,0,-
Anderson Varejao,CLE,38,5,4,37.5,2,6,33.3,33.3,37.5,2,6,33.3,0.0,0,0,-
Rodions Kurucs,MIL,23,21,6,18.8,2,6,33.3,33.3,18.8,2,6,33.3,0.0,0,0,-
Grant Riller,CHA,24,7,2,41.7,5,5,100.0,110.0,33.3,4,4,100,8.3,1,1,100
Tyrell Terry,DAL,20,11,5,31.3,3,5,60.0,60.0,31.3,3,5,60.0,0.0,0,0,-
Chris Silva,SAC,24,15,4,31.3,3,5,60.0,60.0,31.3,3,5,60.0,0.0,0,0,-
Amida Brimah,IND,27,5,3,62.5,3,5,60.0,60.0,62.5,3,5,60.0,0.0,0,0,-
Axel Toupane,MIL,28,8,3,45.5,3,5,60.0,60.0,45.5,3,5,60.0,0.0,0,0,-
Tim Frazier,MEM,30,5,4,25.0,2,5,40.0,40.0,25.0,2,5,40.0,0.0,0,0,-
Elijah Bryant,MIL,26,1,1,38.5,2,5,40.0,40.0,38.5,2,5,40.0,0.0,0,0,-
Jalen Lecque,IND,21,4,2,55.6,1,5,20.0,20.0,55.6,1,5,20.0,0.0,0,0,-
Anthony Tolliver,PHI,36,11,5,29.4,0,5,0.0,0.0,11.8,0,2,0.0,17.6,0,3,0.0
Gary Payton II,GSW,28,10,3,30.8,4,4,100.0,100.0,30.8,4,4,100,0.0,0,0,-
Nick Richards,CHA,23,18,4,44.4,3,4,75.0,75.0,44.4,3,4,75.0,0.0,0,0,-
Cam Reynolds,HOU,26,5,2,22.2,2,4,50.0,50.0,22.2,2,4,50.0,0.0,0,0,-
Jontay Porter,MEM,21,11,3,26.7,2,4,50.0,50.0,20.0,2,3,66.7,6.7,0,1,0.0
Jaylen Adams,MIL,25,7,2,50.0,1,4,25.0,25.0,50.0,1,4,25.0,0.0,0,0,-
Udoka Azubuike,UTA,21,15,3,44.4,1,4,25.0,25.0,44.4,1,4,25.0,0.0,0,0,-
Didi Louzada,NOP,21,3,2,30.8,1,4,25.0,25.0,30.8,1,4,25.0,0.0,0,0,-
Karim Mane,ORL,21,10,4,30.8,1,4,25.0,25.0,30.8,1,4,25.0,0.0,0,0,-
Jared Dudley,LAL,35,12,3,33.3,2,3,66.7,100.0,11.1,0,1,0.0,22.2,2,2,100
Henry Ellenson,TOR,24,2,1,21.4,2,3,66.7,66.7,21.4,2,3,66.7,0.0,0,0,-
Elijah Hughes,UTA,23,18,3,10.3,1,3,33.3,33.3,10.3,1,3,33.3,0.0,0,0,-
Andre Roberson,BKN,29,5,1,21.4,0,3,0.0,0.0,21.4,0,3,0.0,0.0,0,0,-
Ray Spalding,HOU,24,2,2,50.0,1,2,50.0,50.0,50.0,1,2,50.0,0.0,0,0,-
Terrance Ferguson,PHI,23,13,2,28.6,1,2,50.0,50.0,28.6,1,2,50.0,0.0,0,0,-
Vincent Poirier,PHI,27,10,2,16.7,1,2,50.0,50.0,16.7,1,2,50.0,0.0,0,0,-
Brian Bowen II,IND,22,6,1,50.0,1,2,50.0,50.0,50.0,1,2,50.0,0.0,0,0,-
James Nunnally,NOP,30,9,2,15.4,1,2,50.0,75.0,0.0,0,0,-,15.4,1,2,50.0
Marques Bolden,CLE,23,6,1,33.3,1,1,100.0,100.0,33.3,1,1,100,0.0,0,0,-
Patrick McCaw,TOR,25,5,1,100.0,1,1,100.0,100.0,100.0,1,1,100,0.0,0,0,-
Theo Pinson,NYK,25,17,1,11.1,1,1,100.0,100.0,11.1,1,1,100,0.0,0,0,-
Justin Robinson,OKC,23,9,1,4.8,0,1,0.0,0.0,4.8,0,1,0.0,0.0,0,0,-
Malik Fitts,LAC,23,3,1,33.3,0,1,0.0,0.0,33.3,0,1,0.0,0.0,0,0,-
